Postcode,Area,District,Total,Males,Females,Occupied_Households
L1  0AF,L1,0AF,79,38,41,45
L1  1DA,L1,1DA,2,1,1,1
L1  1HW,L1,1HW,6,3,3,4
L1  1JJ,L1,1JJ,3,2,1,3
L1  1JN,L1,1JN,16,10,6,6
L1  1JP,L1,1JP,3,1,2,2
L1  1JQ,L1,1JQ,20,12,8,11
L1  1JW,L1,1JW,10,5,5,8
L1  1LE,L1,1LE,10,8,2,5
L1  1RD,L1,1RD,174,79,95,0
L1  1RJ,L1,1RJ,1,1,0,1
L1  2SA,L1,2SA,8,7,1,5
L1  2SJ,L1,2SJ,18,12,6,12
L1  2SR,L1,2SR,2,1,1,2
L1  2SS,L1,2SS,124,81,43,76
L1  2ST,L1,2ST,40,24,16,30
L1  2SU,L1,2SU,164,89,75,86
L1  2SX,L1,2SX,13,7,6,9
L1  2TE,L1,2TE,19,12,7,13
L1  2TQ,L1,2TQ,13,7,6,10
L1  2TR,L1,2TR,9,5,4,4
L1  3BH,L1,3BH,103,65,38,72
L1  3BL,L1,3BL,6,5,1,3
L1  3BN,L1,3BN,53,31,22,31
L1  3DD,L1,3DD,2,1,1,1
L1  3DT,L1,3DT,41,26,15,26
L1  3DY,L1,3DY,3,2,1,1
L1  3EB,L1,3EB,45,32,13,28
L1  3ED,L1,3ED,19,16,3,4
L1  3EU,L1,3EU,11,8,3,5
L1  4AA,L1,4AA,6,5,1,6
L1  4AG,L1,4AG,1,0,1,1
L1  4AL,L1,4AL,18,12,6,14
L1  4AN,L1,4AN,38,24,14,25
L1  4AQ,L1,4AQ,14,9,5,9
L1  4AR,L1,4AR,73,42,31,45
L1  4AZ,L1,4AZ,22,14,8,5
L1  4BE,L1,4BE,22,18,4,17
L1  4BL,L1,4BL,23,14,9,5
L1  4BN,L1,4BN,52,28,24,34
L1  4BW,L1,4BW,5,3,2,2
L1  4DA,L1,4DA,2,2,0,2
L1  4DE,L1,4DE,80,36,44,32
L1  4DL,L1,4DL,101,50,51,59
L1  4DN,L1,4DN,1,1,0,1
L1  4DQ,L1,4DQ,110,76,34,74
L1  4DR,L1,4DR,76,51,25,39
L1  4EA,L1,4EA,8,5,3,5
L1  4EU,L1,4EU,3,3,0,2
L1  4EZ,L1,4EZ,21,13,8,7
L1  4HF,L1,4HF,17,10,7,11
L1  4HR,L1,4HR,11,8,3,5
L1  4HY,L1,4HY,7,4,3,3
L1  4JF,L1,4JF,10,4,6,7
L1  4JN,L1,4JN,35,28,7,12
L1  4JQ,L1,4JQ,16,7,9,11
L1  4JR,L1,4JR,25,16,9,20
L1  4JS,L1,4JS,72,43,29,43
L1  4JX,L1,4JX,3,2,1,2
L1  4NL,L1,4NL,51,36,15,32
L1  4NU,L1,4NU,8,4,4,4
L1  5AA,L1,5AA,1,0,1,0
L1  5AP,L1,5AP,10,6,4,7
L1  5AQ,L1,5AQ,96,62,34,54
L1  5AT,L1,5AT,22,15,7,16
L1  5AY,L1,5AY,21,12,9,19
L1  5BB,L1,5BB,122,66,56,71
L1  5BE,L1,5BE,14,7,7,9
L1  5BF,L1,5BF,70,47,23,49
L1  5BG,L1,5BG,66,36,30,43
L1  5BL,L1,5BL,80,52,28,45
L1  5BN,L1,5BN,47,29,18,25
L1  5BQ,L1,5BQ,2,1,1,2
L1  5BS,L1,5BS,105,64,41,67
L1  5BU,L1,5BU,173,92,81,101
L1  5BW,L1,5BW,125,77,48,86
L1  5DA,L1,5DA,46,28,18,26
L1  5DB,L1,5DB,6,2,4,4
L1  5DD,L1,5DD,27,19,8,16
L1  5DF,L1,5DF,66,25,41,40
L1  5DG,L1,5DG,47,26,21,15
L1  5DL,L1,5DL,93,39,54,51
L1  5DN,L1,5DN,86,44,42,45
L1  5DP,L1,5DP,19,8,11,6
L1  5DQ,L1,5DQ,32,13,19,16
L1  5DW,L1,5DW,30,17,13,19
L1  5DY,L1,5DY,40,21,19,26
L1  5EA,L1,5EA,28,17,11,14
L1  5EB,L1,5EB,15,6,9,9
L1  5EF,L1,5EF,23,10,13,10
L1  5EG,L1,5EG,25,12,13,12
L1  5EH,L1,5EH,34,18,16,13
L1  5EL,L1,5EL,70,55,15,42
L1  5EQ,L1,5EQ,31,13,18,19
L1  5ES,L1,5ES,25,11,14,14
L1  5EU,L1,5EU,5,1,4,2
L1  5EY,L1,5EY,61,35,26,44
L1  5EZ,L1,5EZ,13,8,5,6
L1  5FD,L1,5FD,90,57,33,61
L1  5FE,L1,5FE,63,37,26,35
L1  5FS,L1,5FS,58,27,31,34
L1  5GA,L1,5GA,21,13,8,15
L1  5GB,L1,5GB,18,9,9,13
L1  5HA,L1,5HA,15,8,7,4
L1  5HS,L1,5HS,27,15,12,15
L1  5HY,L1,5HY,37,15,22,21
L1  5HZ,L1,5HZ,24,11,13,11
L1  5JD,L1,5JD,40,13,27,19
L1  5JE,L1,5JE,21,8,13,11
L1  5JH,L1,5JH,15,5,10,6
L1  5JJ,L1,5JJ,8,6,2,5
L1  5JL,L1,5JL,24,11,13,6
L1  5JP,L1,5JP,16,12,4,9
L1  6AA,L1,6AA,25,14,11,16
L1  6AF,L1,6AF,9,5,4,8
L1  6BA,L1,6BA,18,13,5,15
L1  6BB,L1,6BB,21,11,10,14
L1  6BD,L1,6BD,21,14,7,14
L1  6BG,L1,6BG,18,12,6,13
L1  6BU,L1,6BU,53,26,27,31
L1  6BW,L1,6BW,33,21,12,19
L1  6BX,L1,6BX,13,10,3,11
L1  6DP,L1,6DP,18,13,5,15
L1  6DQ,L1,6DQ,87,47,40,61
L1  6DT,L1,6DT,6,2,4,4
L1  6DX,L1,6DX,16,10,6,12
L1  6ER,L1,6ER,39,23,16,27
L1  7AY,L1,7AY,4,1,3,2
L1  7BA,L1,7BA,77,44,33,49
L1  7BG,L1,7BG,50,34,16,35
L1  7BJ,L1,7BJ,45,30,15,26
L1  7BL,L1,7BL,95,52,43,61
L1  7BP,L1,7BP,70,28,42,27
L1  7BR,L1,7BR,172,80,92,16
L1  7BS,L1,7BS,95,37,58,33
L1  7BT,L1,7BT,274,97,177,43
L1  7BW,L1,7BW,45,20,25,33
L1  7BX,L1,7BX,107,47,60,60
L1  7BZ,L1,7BZ,12,4,8,9
L1  8DG,L1,8DG,48,28,20,28
L1  8DL,L1,8DL,62,35,27,37
L1  8DN,L1,8DN,29,17,12,16
L1  8DP,L1,8DP,56,34,22,37
L1  8DQ,L1,8DQ,2,2,0,2
L1  8DW,L1,8DW,89,52,37,55
L1  8DX,L1,8DX,66,40,26,41
L1  8DZ,L1,8DZ,29,24,5,14
L1  8EE,L1,8EE,4,3,1,0
L1  8EF,L1,8EF,17,10,7,9
L1  8HG,L1,8HG,32,17,15,21
L1  8LN,L1,8LN,59,41,18,45
L1  8LP,L1,8LP,78,49,29,58
L1  8LU,L1,8LU,18,6,12,9
L1  8LW,L1,8LW,7,4,3,4
L1  8LZ,L1,8LZ,59,41,18,40
L1  8ND,L1,8ND,122,75,47,73
L1  9AA,L1,9AA,23,13,10,12
L1  9AD,L1,9AD,27,16,11,16
L1  9AF,L1,9AF,6,4,2,4
L1  9AL,L1,9AL,23,14,9,8
L1  9AR,L1,9AR,8,4,4,4
L1  9AS,L1,9AS,14,9,5,8
L1  9AT,L1,9AT,3,2,1,2
L1  9AX,L1,9AX,4,2,2,3
L1  9BB,L1,9BB,44,28,16,33
L1  9BG,L1,9BG,50,24,26,23
L1  9BQ,L1,9BQ,21,18,3,7
L1  9BZ,L1,9BZ,17,11,6,11
L1  9DE,L1,9DE,1,0,1,1
L1  9DN,L1,9DN,54,29,25,26
L1  9DP,L1,9DP,4,4,0,3
L1  9DS,L1,9DS,39,26,13,21
L1  9DT,L1,9DT,3,2,1,3
L1  9DU,L1,9DU,7,6,1,6
L1  9DW,L1,9DW,44,27,17,20
L1  9DY,L1,9DY,14,11,3,4
L1  9DZ,L1,9DZ,34,16,18,19
L1  9EA,L1,9EA,5,4,1,4
L1  9EF,L1,9EF,11,7,4,7
L1  9EH,L1,9EH,7,5,2,4
L1  9EN,L1,9EN,21,14,7,7
L1  9ER,L1,9ER,7,4,3,2
L1  9EW,L1,9EW,6,4,2,4
L1  9EX,L1,9EX,9,4,5,5
L1  9HB,L1,9HB,45,19,26,23
L1  9HD,L1,9HD,40,22,18,18
L1  9HE,L1,9HE,6,4,2,4
L1  9JG,L1,9JG,98,34,64,20
L10 0AD,L10,0AD,12,7,5,6
L10 0AE,L10,0AE,26,11,15,14
L10 0AF,L10,0AF,23,14,9,9
L10 0AG,L10,0AG,88,44,44,39
L10 0AH,L10,0AH,34,16,18,14
L10 0AJ,L10,0AJ,82,36,46,32
L10 0AL,L10,0AL,86,42,44,40
L10 0AN,L10,0AN,80,42,38,31
L10 0AP,L10,0AP,39,17,22,14
L10 0AQ,L10,0AQ,31,31,0,0
L10 0AR,L10,0AR,123,65,58,53
L10 0AS,L10,0AS,37,18,19,32
L10 0AT,L10,0AT,50,25,25,19
L10 0AW,L10,0AW,52,26,26,21
L10 0AY,L10,0AY,49,24,25,18
L10 1LA,L10,1LA,92,43,49,32
L10 1LB,L10,1LB,21,12,9,12
L10 1LD,L10,1LD,7,4,3,4
L10 1LF,L10,1LF,51,23,28,21
L10 1LG,L10,1LG,61,30,31,28
L10 1LH,L10,1LH,27,10,17,10
L10 1LJ,L10,1LJ,45,20,25,18
L10 1LL,L10,1LL,38,14,24,17
L10 1LN,L10,1LN,93,47,46,35
L10 1LP,L10,1LP,148,67,81,50
L10 1LQ,L10,1LQ,85,43,42,36
L10 1LR,L10,1LR,65,34,31,32
L10 1LS,L10,1LS,66,35,31,28
L10 1LT,L10,1LT,61,26,35,26
L10 1LU,L10,1LU,43,22,21,22
L10 1LX,L10,1LX,65,35,30,20
L10 1NB,L10,1NB,114,50,64,43
L10 1ND,L10,1ND,28,13,15,10
L10 1NE,L10,1NE,37,18,19,12
L10 1NF,L10,1NF,66,32,34,29
L10 1NG,L10,1NG,84,40,44,33
L10 1NH,L10,1NH,155,76,79,63
L10 1NJ,L10,1NJ,17,8,9,11
L10 1NL,L10,1NL,2,0,2,2
L10 2JD,L10,2JD,9,3,6,6
L10 2JE,L10,2JE,51,27,24,19
L10 2JF,L10,2JF,75,33,42,24
L10 2JG,L10,2JG,74,37,37,27
L10 2JH,L10,2JH,16,8,8,10
L10 2JJ,L10,2JJ,67,36,31,34
L10 2JL,L10,2JL,36,16,20,17
L10 2JN,L10,2JN,60,27,33,25
L10 2JP,L10,2JP,32,14,18,16
L10 2JQ,L10,2JQ,105,54,51,34
L10 2JR,L10,2JR,31,14,17,16
L10 2JS,L10,2JS,34,16,18,19
L10 2JT,L10,2JT,38,23,15,13
L10 2JU,L10,2JU,50,22,28,27
L10 2JW,L10,2JW,43,21,22,17
L10 2JX,L10,2JX,33,15,18,10
L10 2JY,L10,2JY,29,14,15,14
L10 2JZ,L10,2JZ,32,15,17,18
L10 2LA,L10,2LA,39,19,20,15
L10 2LB,L10,2LB,31,14,17,18
L10 2LD,L10,2LD,79,41,38,29
L10 2LE,L10,2LE,32,16,16,13
L10 2LF,L10,2LF,53,21,32,22
L10 2LG,L10,2LG,61,26,35,27
L10 2LH,L10,2LH,8,3,5,6
L10 2LQ,L10,2LQ,53,21,32,21
L10 3JA,L10,3JA,5,3,2,3
L10 3JD,L10,3JD,46,26,20,18
L10 3JE,L10,3JE,72,37,35,27
L10 3JF,L10,3JF,51,23,28,26
L10 3JG,L10,3JG,22,12,10,11
L10 3JH,L10,3JH,64,35,29,28
L10 3JJ,L10,3JJ,64,29,35,24
L10 3JL,L10,3JL,119,54,65,49
L10 3JN,L10,3JN,72,36,36,27
L10 3JP,L10,3JP,40,16,24,16
L10 3JQ,L10,3JQ,44,22,22,14
L10 3JR,L10,3JR,41,21,20,22
L10 3JS,L10,3JS,30,16,14,14
L10 3JT,L10,3JT,50,21,29,22
L10 3JU,L10,3JU,55,26,29,24
L10 3JW,L10,3JW,37,15,22,12
L10 3JX,L10,3JX,22,12,10,12
L10 3JY,L10,3JY,51,30,21,20
L10 3JZ,L10,3JZ,54,32,22,20
L10 3LA,L10,3LA,53,26,27,22
L10 3LB,L10,3LB,52,28,24,23
L10 3LD,L10,3LD,48,25,23,18
L10 3LE,L10,3LE,68,34,34,24
L10 3LF,L10,3LF,40,21,19,18
L10 3LG,L10,3LG,65,27,38,24
L10 3LH,L10,3LH,71,30,41,24
L10 3LJ,L10,3LJ,50,25,25,25
L10 3LL,L10,3LL,54,26,28,27
L10 3LQ,L10,3LQ,46,21,25,16
L10 4UE,L10,4UE,113,52,61,45
L10 4UF,L10,4UF,172,92,80,58
L10 4UG,L10,4UG,34,20,14,16
L10 4UH,L10,4UH,26,10,16,8
L10 4UJ,L10,4UJ,53,26,27,17
L10 4UN,L10,4UN,19,10,9,6
L10 4UP,L10,4UP,26,15,11,11
L10 4UQ,L10,4UQ,43,20,23,15
L10 4UR,L10,4UR,28,14,14,12
L10 4US,L10,4US,125,61,64,53
L10 4UT,L10,4UT,147,73,74,62
L10 4UU,L10,4UU,14,8,6,5
L10 4UW,L10,4UW,22,11,11,10
L10 4UX,L10,4UX,26,15,11,10
L10 4UY,L10,4UY,29,14,15,12
L10 4UZ,L10,4UZ,78,34,44,33
L10 4XA,L10,4XA,5,3,2,1
L10 4XG,L10,4XG,80,39,41,33
L10 4XH,L10,4XH,30,11,19,14
L10 4XJ,L10,4XJ,90,46,44,33
L10 4XL,L10,4XL,50,25,25,19
L10 4XN,L10,4XN,55,28,27,23
L10 4XP,L10,4XP,104,50,54,40
L10 4XQ,L10,4XQ,30,14,16,11
L10 4XR,L10,4XR,77,41,36,27
L10 4XS,L10,4XS,31,16,15,13
L10 4XT,L10,4XT,59,28,31,27
L10 4XU,L10,4XU,9,5,4,2
L10 4XW,L10,4XW,51,23,28,23
L10 4XX,L10,4XX,35,14,21,15
L10 4XY,L10,4XY,92,40,52,42
L10 4XZ,L10,4XZ,44,20,24,21
L10 4YA,L10,4YA,36,20,16,16
L10 4YB,L10,4YB,47,23,24,20
L10 4YD,L10,4YD,37,18,19,20
L10 4YE,L10,4YE,151,67,84,59
L10 4YF,L10,4YF,62,34,28,33
L10 4YG,L10,4YG,104,44,60,44
L10 4YH,L10,4YH,109,56,53,37
L10 4YJ,L10,4YJ,41,21,20,19
L10 4YL,L10,4YL,15,6,9,8
L10 4YN,L10,4YN,40,17,23,20
L10 4YP,L10,4YP,77,41,36,34
L10 4YQ,L10,4YQ,7,3,4,4
L10 4YR,L10,4YR,41,18,23,19
L10 4YS,L10,4YS,74,37,37,30
L10 4YT,L10,4YT,87,46,41,32
L10 4YU,L10,4YU,36,19,17,12
L10 4YW,L10,4YW,54,23,31,20
L10 4YX,L10,4YX,56,27,29,22
L10 6LA,L10,6LA,41,21,20,15
L10 6LB,L10,6LB,15,7,8,8
L10 6LE,L10,6LE,49,25,24,21
L10 6LF,L10,6LF,46,27,19,17
L10 6LG,L10,6LG,56,27,29,24
L10 6LH,L10,6LH,75,37,38,26
L10 6LJ,L10,6LJ,64,32,32,24
L10 6LL,L10,6LL,56,25,31,33
L10 6LN,L10,6LN,36,17,19,16
L10 6LP,L10,6LP,63,23,40,26
L10 6LR,L10,6LR,51,26,25,24
L10 6LS,L10,6LS,47,20,27,22
L10 6LT,L10,6LT,76,36,40,41
L10 6LU,L10,6LU,76,33,43,32
L10 6LW,L10,6LW,24,8,16,17
L10 6LX,L10,6LX,54,25,29,24
L10 6LY,L10,6LY,64,36,28,25
L10 6LZ,L10,6LZ,52,20,32,24
L10 6NA,L10,6NA,7,5,2,2
L10 6NB,L10,6NB,6,1,5,5
L10 6ND,L10,6ND,32,13,19,12
L10 6NE,L10,6NE,57,24,33,32
L10 6NF,L10,6NF,39,17,22,16
L10 6NG,L10,6NG,62,31,31,26
L10 6NH,L10,6NH,56,26,30,27
L10 6NQ,L10,6NQ,104,53,51,43
L10 7LA,L10,7LA,86,40,46,37
L10 7LB,L10,7LB,77,33,44,27
L10 7LD,L10,7LD,19,9,10,5
L10 7LE,L10,7LE,62,30,32,23
L10 7LF,L10,7LF,90,41,49,35
L10 7LG,L10,7LG,51,26,25,22
L10 7LH,L10,7LH,70,34,36,36
L10 7LJ,L10,7LJ,35,16,19,15
L10 7LL,L10,7LL,57,19,38,29
L10 7LN,L10,7LN,34,17,17,17
L10 7LP,L10,7LP,50,19,31,24
L10 7LQ,L10,7LQ,49,23,26,24
L10 7LR,L10,7LR,44,20,24,23
L10 7LS,L10,7LS,57,20,37,25
L10 7LT,L10,7LT,43,20,23,23
L10 7LU,L10,7LU,25,10,15,11
L10 7LW,L10,7LW,75,33,42,29
L10 7LX,L10,7LX,47,23,24,20
L10 7LY,L10,7LY,68,33,35,31
L10 7LZ,L10,7LZ,52,27,25,29
L10 7NA,L10,7NA,49,24,25,22
L10 7NB,L10,7NB,30,15,15,13
L10 7ND,L10,7ND,24,8,16,12
L10 7NE,L10,7NE,63,31,32,25
L10 7NF,L10,7NF,85,35,50,33
L10 7NG,L10,7NG,73,34,39,32
L10 7NH,L10,7NH,93,38,55,49
L10 7NJ,L10,7NJ,51,23,28,22
L10 7NL,L10,7NL,30,15,15,12
L10 7NN,L10,7NN,51,19,32,19
L10 7NP,L10,7NP,61,26,35,29
L10 7NQ,L10,7NQ,33,11,22,16
L10 7NR,L10,7NR,50,27,23,21
L10 7NS,L10,7NS,44,25,19,31
L10 7NT,L10,7NT,35,15,20,21
L10 7NU,L10,7NU,76,52,24,56
L10 7NW,L10,7NW,58,30,28,25
L10 8JA,L10,8JA,50,25,25,23
L10 8JB,L10,8JB,77,41,36,28
L10 8JD,L10,8JD,46,21,25,16
L10 8JE,L10,8JE,44,23,21,15
L10 8JF,L10,8JF,47,20,27,20
L10 8JG,L10,8JG,85,41,44,34
L10 8JH,L10,8JH,72,36,36,30
L10 8JJ,L10,8JJ,17,8,9,7
L10 8JL,L10,8JL,77,40,37,31
L10 8JN,L10,8JN,138,62,76,55
L10 8JP,L10,8JP,71,34,37,32
L10 8JQ,L10,8JQ,74,36,38,31
L10 8JR,L10,8JR,53,30,23,19
L10 8JS,L10,8JS,22,10,12,10
L10 8JT,L10,8JT,70,39,31,29
L10 8JU,L10,8JU,97,50,47,40
L10 8JW,L10,8JW,59,27,32,23
L10 8JX,L10,8JX,21,12,9,12
L10 8JY,L10,8JY,51,24,27,22
L10 8JZ,L10,8JZ,60,29,31,30
L10 8LA,L10,8LA,61,27,34,30
L10 8LB,L10,8LB,48,26,22,24
L10 8LD,L10,8LD,34,15,19,15
L10 8LE,L10,8LE,17,7,10,6
L10 8LF,L10,8LF,68,33,35,26
L10 8LG,L10,8LG,66,32,34,22
L10 8LH,L10,8LH,50,27,23,18
L10 8LJ,L10,8LJ,52,27,25,20
L10 8LL,L10,8LL,76,36,40,32
L10 8LN,L10,8LN,29,14,15,18
L10 8LQ,L10,8LQ,5,2,3,3
L10 8LR,L10,8LR,75,34,41,26
L10 8LS,L10,8LS,90,39,51,44
L10 8LT,L10,8LT,46,24,22,21
L10 8LU,L10,8LU,49,21,28,22
L10 8LW,L10,8LW,58,26,32,23
L10 8LX,L10,8LX,50,24,26,22
L10 8LY,L10,8LY,20,8,12,9
L10 8ND,L10,8ND,6,2,4,4
L10 9AP,L10,9AP,35,15,20,13
L10 9LA,L10,9LA,48,28,20,23
L10 9LB,L10,9LB,26,15,11,10
L10 9LD,L10,9LD,62,26,36,25
L10 9LE,L10,9LE,39,17,22,19
L10 9LG,L10,9LG,2,2,0,1
L10 9LH,L10,9LH,10,6,4,8
L10 9LJ,L10,9LJ,33,15,18,14
L10 9LL,L10,9LL,67,40,27,41
L10 9LN,L10,9LN,93,47,46,39
L10 9LP,L10,9LP,85,43,42,32
L10 9LQ,L10,9LQ,48,21,27,22
L10 9LR,L10,9LR,68,30,38,30
L10 9LS,L10,9LS,46,22,24,19
L10 9LT,L10,9LT,83,38,45,35
L10 9LU,L10,9LU,77,37,40,27
L10 9LW,L10,9LW,52,24,28,17
L10 9LX,L10,9LX,56,23,33,24
L10 9LY,L10,9LY,83,42,41,38
L10 9LZ,L10,9LZ,73,32,41,28
L10 9NA,L10,9NA,99,40,59,35
L10 9NB,L10,9NB,57,28,29,27
L10 9ND,L10,9ND,97,44,53,34
L10 9NE,L10,9NE,82,35,47,39
L10 9NF,L10,9NF,54,21,33,25
L10 9NG,L10,9NG,231,120,111,70
L10 9NP,L10,9NP,12,4,8,4
L11 0AA,L11,0AA,14,7,7,8
L11 0AB,L11,0AB,14,4,10,6
L11 0AD,L11,0AD,57,23,34,30
L11 0AE,L11,0AE,74,35,39,34
L11 0AF,L11,0AF,34,16,18,23
L11 0AG,L11,0AG,81,35,46,34
L11 0AH,L11,0AH,13,6,7,5
L11 0AJ,L11,0AJ,75,28,47,37
L11 0AL,L11,0AL,36,16,20,13
L11 0AN,L11,0AN,52,20,32,25
L11 0AP,L11,0AP,24,13,11,11
L11 0AQ,L11,0AQ,36,19,17,17
L11 0AR,L11,0AR,26,14,12,8
L11 0AS,L11,0AS,35,18,17,17
L11 0AT,L11,0AT,48,20,28,21
L11 0AU,L11,0AU,42,17,25,14
L11 0AX,L11,0AX,57,32,25,27
L11 0AY,L11,0AY,41,23,18,13
L11 0BG,L11,0BG,18,7,11,9
L11 0BH,L11,0BH,43,21,22,19
L11 0BJ,L11,0BJ,28,11,17,11
L11 0BL,L11,0BL,5,3,2,2
L11 0BN,L11,0BN,42,18,24,16
L11 0BP,L11,0BP,60,17,43,8
L11 0BR,L11,0BR,73,31,42,34
L11 0BT,L11,0BT,43,18,25,23
L11 0BU,L11,0BU,103,53,50,40
L11 0BW,L11,0BW,38,17,21,21
L11 0BX,L11,0BX,14,7,7,4
L11 0BY,L11,0BY,38,15,23,15
L11 0BZ,L11,0BZ,39,18,21,19
L11 0DA,L11,0DA,48,21,27,20
L11 0DB,L11,0DB,16,7,9,10
L11 0DD,L11,0DD,42,20,22,16
L11 0DE,L11,0DE,45,19,26,20
L11 0DF,L11,0DF,45,21,24,18
L11 0DG,L11,0DG,60,25,35,25
L11 0DN,L11,0DN,35,18,17,12
L11 0ED,L11,0ED,2,1,1,1
L11 0EE,L11,0EE,4,3,1,2
L11 1AH,L11,1AH,24,13,11,11
L11 1AJ,L11,1AJ,3,1,2,2
L11 1AN,L11,1AN,54,26,28,28
L11 1AP,L11,1AP,16,6,10,6
L11 1AS,L11,1AS,83,36,47,37
L11 1AT,L11,1AT,52,26,26,23
L11 1AU,L11,1AU,134,62,72,49
L11 1AX,L11,1AX,127,54,73,50
L11 1AY,L11,1AY,83,36,47,31
L11 1AZ,L11,1AZ,39,14,25,16
L11 1BA,L11,1BA,53,24,29,22
L11 1BB,L11,1BB,31,9,22,16
L11 1BD,L11,1BD,32,14,18,12
L11 1BE,L11,1BE,115,56,59,43
L11 1BG,L11,1BG,8,2,6,4
L11 1BL,L11,1BL,37,14,23,16
L11 1BN,L11,1BN,50,28,22,20
L11 1BP,L11,1BP,36,17,19,16
L11 1BQ,L11,1BQ,31,14,17,13
L11 1BR,L11,1BR,71,32,39,33
L11 1BS,L11,1BS,93,43,50,39
L11 1BT,L11,1BT,39,16,23,19
L11 1BU,L11,1BU,77,41,36,31
L11 1BW,L11,1BW,47,25,22,23
L11 1BX,L11,1BX,7,3,4,4
L11 1BY,L11,1BY,1,1,0,1
L11 1DB,L11,1DB,25,13,12,9
L11 1DE,L11,1DE,67,28,39,25
L11 1DF,L11,1DF,55,24,31,25
L11 1DG,L11,1DG,10,3,7,2
L11 1DH,L11,1DH,119,60,59,45
L11 1DJ,L11,1DJ,34,14,20,12
L11 1DN,L11,1DN,27,15,12,11
L11 1DP,L11,1DP,62,33,29,24
L11 1DQ,L11,1DQ,43,18,25,19
L11 1DR,L11,1DR,107,52,55,43
L11 1DS,L11,1DS,38,14,24,21
L11 1DU,L11,1DU,156,72,84,61
L11 1DW,L11,1DW,51,33,18,25
L11 1EB,L11,1EB,4,2,2,2
L11 1EE,L11,1EE,63,21,42,24
L11 1EF,L11,1EF,47,19,28,18
L11 1EG,L11,1EG,87,44,43,39
L11 1EH,L11,1EH,75,39,36,29
L11 1EJ,L11,1EJ,35,15,20,16
L11 1EL,L11,1EL,20,14,6,11
L11 1EP,L11,1EP,32,16,16,12
L11 1EQ,L11,1EQ,56,27,29,30
L11 1ET,L11,1ET,2,0,2,1
L11 1EW,L11,1EW,36,19,17,16
L11 1EZ,L11,1EZ,73,32,41,31
L11 1HA,L11,1HA,72,38,34,32
L11 1HB,L11,1HB,79,30,49,32
L11 1HH,L11,1HH,2,1,1,1
L11 1JG,L11,1JG,23,9,14,21
L11 2RZ,L11,2RZ,75,39,36,29
L11 2SA,L11,2SA,62,26,36,24
L11 2SB,L11,2SB,60,32,28,25
L11 2SD,L11,2SD,53,24,29,24
L11 2SE,L11,2SE,13,6,7,7
L11 2SF,L11,2SF,49,18,31,17
L11 2SH,L11,2SH,101,48,53,46
L11 2SJ,L11,2SJ,76,35,41,36
L11 2SN,L11,2SN,108,57,51,44
L11 2SP,L11,2SP,41,17,24,17
L11 2SQ,L11,2SQ,79,40,39,31
L11 2SR,L11,2SR,88,38,50,35
L11 2SS,L11,2SS,115,48,67,46
L11 2SW,L11,2SW,67,28,39,28
L11 2TA,L11,2TA,30,17,13,13
L11 2TB,L11,2TB,67,26,41,26
L11 2TD,L11,2TD,55,24,31,24
L11 2TE,L11,2TE,77,32,45,35
L11 2TF,L11,2TF,87,48,39,30
L11 2TG,L11,2TG,50,18,32,24
L11 2TH,L11,2TH,28,10,18,14
L11 2TJ,L11,2TJ,105,42,63,44
L11 2TL,L11,2TL,77,38,39,35
L11 2TN,L11,2TN,79,33,46,31
L11 2TP,L11,2TP,73,38,35,36
L11 2TQ,L11,2TQ,54,26,28,23
L11 2TR,L11,2TR,118,47,71,47
L11 2TS,L11,2TS,110,59,51,37
L11 2TT,L11,2TT,69,25,44,29
L11 2TU,L11,2TU,35,18,17,23
L11 2TW,L11,2TW,68,31,37,29
L11 2TX,L11,2TX,62,27,35,30
L11 2TY,L11,2TY,52,26,26,22
L11 2TZ,L11,2TZ,66,23,43,32
L11 2UA,L11,2UA,35,13,22,13
L11 2UB,L11,2UB,27,12,15,11
L11 2UD,L11,2UD,59,24,35,25
L11 2UE,L11,2UE,48,19,29,19
L11 2UF,L11,2UF,52,29,23,18
L11 2UG,L11,2UG,52,22,30,21
L11 2UH,L11,2UH,120,52,68,46
L11 2UJ,L11,2UJ,80,39,41,34
L11 2UL,L11,2UL,102,47,55,46
L11 2UN,L11,2UN,29,19,10,18
L11 2UP,L11,2UP,38,16,22,18
L11 2UQ,L11,2UQ,75,37,38,34
L11 2UR,L11,2UR,53,28,25,20
L11 2US,L11,2US,4,2,2,2
L11 2UT,L11,2UT,44,15,29,41
L11 2UU,L11,2UU,81,31,50,36
L11 2UW,L11,2UW,20,9,11,6
L11 2UX,L11,2UX,116,49,67,45
L11 2UY,L11,2UY,67,24,43,30
L11 2UZ,L11,2UZ,63,28,35,26
L11 2WX,L11,2WX,66,29,37,25
L11 2XE,L11,2XE,5,1,4,2
L11 2XF,L11,2XF,4,2,2,2
L11 2XG,L11,2XG,8,4,4,2
L11 2XP,L11,2XP,12,4,8,7
L11 2XU,L11,2XU,13,8,5,8
L11 2XY,L11,2XY,22,13,9,8
L11 2YA,L11,2YA,77,34,43,37
L11 2YB,L11,2YB,24,12,12,12
L11 2YE,L11,2YE,22,8,14,9
L11 2YF,L11,2YF,36,14,22,33
L11 2YG,L11,2YG,56,25,31,25
L11 2YH,L11,2YH,36,19,17,14
L11 2YJ,L11,2YJ,75,31,44,29
L11 2YQ,L11,2YQ,29,13,16,26
L11 2YX,L11,2YX,32,11,21,18
L11 3AA,L11,3AA,22,13,9,9
L11 3AB,L11,3AB,82,46,36,35
L11 3AD,L11,3AD,40,20,20,18
L11 3AE,L11,3AE,77,32,45,35
L11 3AF,L11,3AF,71,33,38,36
L11 3AG,L11,3AG,89,47,42,37
L11 3AH,L11,3AH,56,23,33,24
L11 3AJ,L11,3AJ,72,25,47,32
L11 3AL,L11,3AL,87,33,54,40
L11 3AN,L11,3AN,44,24,20,18
L11 3AP,L11,3AP,102,51,51,45
L11 3AQ,L11,3AQ,104,54,50,42
L11 3AR,L11,3AR,83,41,42,37
L11 3AS,L11,3AS,77,39,38,34
L11 3AT,L11,3AT,76,36,40,32
L11 3AU,L11,3AU,41,21,20,15
L11 3AX,L11,3AX,66,33,33,26
L11 3AY,L11,3AY,68,31,37,26
L11 3AZ,L11,3AZ,36,16,20,14
L11 3BA,L11,3BA,26,15,11,19
L11 3BB,L11,3BB,44,25,19,19
L11 3BD,L11,3BD,24,12,12,10
L11 3BE,L11,3BE,9,4,5,4
L11 3BG,L11,3BG,84,42,42,32
L11 3BH,L11,3BH,97,46,51,36
L11 3BJ,L11,3BJ,113,49,64,47
L11 3BL,L11,3BL,98,43,55,39
L11 3BN,L11,3BN,50,27,23,19
L11 3BP,L11,3BP,32,14,18,13
L11 3BQ,L11,3BQ,82,43,39,29
L11 3BR,L11,3BR,53,24,29,21
L11 3BS,L11,3BS,56,29,27,26
L11 3BT,L11,3BT,83,36,47,34
L11 3BU,L11,3BU,33,12,21,13
L11 3BW,L11,3BW,40,18,22,16
L11 3BX,L11,3BX,73,38,35,28
L11 3BY,L11,3BY,91,46,45,39
L11 3BZ,L11,3BZ,92,40,52,37
L11 3DA,L11,3DA,65,29,36,24
L11 3DB,L11,3DB,35,15,20,13
L11 3DD,L11,3DD,85,42,43,33
L11 3DE,L11,3DE,83,36,47,33
L11 3DF,L11,3DF,84,38,46,34
L11 3DG,L11,3DG,87,43,44,40
L11 3DH,L11,3DH,26,15,11,12
L11 3DJ,L11,3DJ,46,24,22,14
L11 3DL,L11,3DL,33,17,16,14
L11 3DN,L11,3DN,62,34,28,30
L11 3DP,L11,3DP,50,25,25,18
L11 3DR,L11,3DR,39,17,22,17
L11 3DS,L11,3DS,73,35,38,33
L11 3DT,L11,3DT,29,15,14,9
L11 3DU,L11,3DU,88,38,50,38
L11 3DW,L11,3DW,74,33,41,29
L11 3DX,L11,3DX,77,27,50,29
L11 3DY,L11,3DY,43,21,22,19
L11 3DZ,L11,3DZ,42,16,26,16
L11 3EA,L11,3EA,63,27,36,26
L11 3EB,L11,3EB,70,37,33,27
L11 3ED,L11,3ED,42,21,21,16
L11 3EE,L11,3EE,122,58,64,43
L11 3EF,L11,3EF,85,39,46,33
L11 3EG,L11,3EG,42,21,21,15
L11 3EL,L11,3EL,56,27,29,37
L11 3EQ,L11,3EQ,28,12,16,12
L11 4BD,L11,4BD,14,9,5,4
L11 4BH,L11,4BH,25,10,15,10
L11 4RA,L11,4RA,15,9,6,8
L11 4RB,L11,4RB,34,16,18,14
L11 4RD,L11,4RD,16,6,10,7
L11 4RG,L11,4RG,30,13,17,14
L11 4RH,L11,4RH,38,16,22,13
L11 4RJ,L11,4RJ,87,58,29,41
L11 4RN,L11,4RN,13,5,8,5
L11 4RP,L11,4RP,37,21,16,16
L11 4RQ,L11,4RQ,20,7,13,10
L11 4RR,L11,4RR,14,6,8,7
L11 4RS,L11,4RS,25,10,15,11
L11 4RT,L11,4RT,10,5,5,4
L11 4RU,L11,4RU,28,13,15,14
L11 4RW,L11,4RW,70,34,36,35
L11 4RX,L11,4RX,42,20,22,20
L11 4RY,L11,4RY,14,3,11,4
L11 4RZ,L11,4RZ,47,21,26,14
L11 4SA,L11,4SA,49,28,21,25
L11 4SB,L11,4SB,63,22,41,20
L11 4SE,L11,4SE,50,21,29,24
L11 4SF,L11,4SF,9,5,4,6
L11 4SH,L11,4SH,39,18,21,16
L11 4SJ,L11,4SJ,10,6,4,5
L11 4SL,L11,4SL,58,31,27,17
L11 4SQ,L11,4SQ,79,38,41,36
L11 4SR,L11,4SR,40,18,22,16
L11 4SS,L11,4SS,53,21,32,22
L11 4ST,L11,4ST,47,19,28,22
L11 4SU,L11,4SU,46,21,25,20
L11 4SW,L11,4SW,19,9,10,6
L11 4SZ,L11,4SZ,76,31,45,34
L11 4TA,L11,4TA,44,18,26,19
L11 4TB,L11,4TB,39,13,26,22
L11 4TD,L11,4TD,12,5,7,7
L11 4TE,L11,4TE,42,20,22,16
L11 4TG,L11,4TG,62,29,33,31
L11 4TH,L11,4TH,16,11,5,6
L11 4TJ,L11,4TJ,15,7,8,7
L11 4TL,L11,4TL,59,26,33,25
L11 4TN,L11,4TN,28,15,13,11
L11 4TP,L11,4TP,13,6,7,5
L11 4TQ,L11,4TQ,58,27,31,30
L11 4TR,L11,4TR,16,5,11,9
L11 4TS,L11,4TS,23,12,11,11
L11 4TT,L11,4TT,18,7,11,9
L11 4TW,L11,4TW,22,8,14,14
L11 4TY,L11,4TY,29,10,19,9
L11 4TZ,L11,4TZ,4,0,4,2
L11 4UA,L11,4UA,68,30,38,29
L11 4UD,L11,4UD,126,58,68,49
L11 4UH,L11,4UH,155,76,79,46
L11 4UJ,L11,4UJ,23,10,13,14
L11 4UL,L11,4UL,31,15,16,17
L11 4UN,L11,4UN,46,26,20,15
L11 4UP,L11,4UP,28,16,12,12
L11 4UQ,L11,4UQ,179,99,80,52
L11 4UR,L11,4UR,151,76,75,62
L11 4US,L11,4US,69,34,35,30
L11 4UW,L11,4UW,218,102,116,78
L11 5AA,L11,5AA,45,21,24,24
L11 5AB,L11,5AB,112,47,65,43
L11 5AD,L11,5AD,55,26,29,23
L11 5AE,L11,5AE,25,11,14,10
L11 5AF,L11,5AF,1,0,1,1
L11 5AH,L11,5AH,112,56,56,43
L11 5AJ,L11,5AJ,18,6,12,9
L11 5AN,L11,5AN,69,37,32,29
L11 5AQ,L11,5AQ,59,34,25,24
L11 5AR,L11,5AR,107,42,65,41
L11 5AS,L11,5AS,50,19,31,25
L11 5AT,L11,5AT,59,29,30,24
L11 5AU,L11,5AU,54,24,30,23
L11 5AW,L11,5AW,6,3,3,1
L11 5AX,L11,5AX,87,38,49,35
L11 5AY,L11,5AY,94,49,45,30
L11 5AZ,L11,5AZ,62,27,35,25
L11 5BA,L11,5BA,68,27,41,33
L11 5BB,L11,5BB,80,34,46,26
L11 5BD,L11,5BD,70,35,35,27
L11 5BE,L11,5BE,81,34,47,34
L11 5BG,L11,5BG,92,44,48,36
L11 5BH,L11,5BH,79,32,47,29
L11 5BJ,L11,5BJ,36,16,20,17
L11 5BL,L11,5BL,101,44,57,47
L11 5BQ,L11,5BQ,77,41,36,35
L11 6GA,L11,6GA,24,10,14,11
L11 6LA,L11,6LA,89,34,55,41
L11 6LB,L11,6LB,18,5,13,8
L11 6LD,L11,6LD,54,24,30,23
L11 6LE,L11,6LE,46,22,24,14
L11 6LF,L11,6LF,44,19,25,17
L11 6LG,L11,6LG,60,33,27,27
L11 6LH,L11,6LH,12,5,7,4
L11 6LJ,L11,6LJ,12,6,6,8
L11 6LL,L11,6LL,12,4,8,5
L11 6LN,L11,6LN,85,41,44,27
L11 6LP,L11,6LP,20,10,10,11
L11 6LQ,L11,6LQ,76,39,37,30
L11 6LR,L11,6LR,34,14,20,15
L11 6LS,L11,6LS,47,23,24,23
L11 6LT,L11,6LT,27,14,13,9
L11 6LU,L11,6LU,31,11,20,15
L11 6LW,L11,6LW,60,31,29,23
L11 6LX,L11,6LX,15,7,8,10
L11 6LY,L11,6LY,30,13,17,16
L11 6LZ,L11,6LZ,13,6,7,8
L11 6NA,L11,6NA,88,41,47,37
L11 6NB,L11,6NB,2,1,1,2
L11 6ND,L11,6ND,25,12,13,14
L11 6NE,L11,6NE,42,22,20,22
L11 6NF,L11,6NF,47,20,27,21
L11 6NP,L11,6NP,51,19,32,41
L11 7AA,L11,7AA,55,30,25,25
L11 7AB,L11,7AB,45,22,23,16
L11 7AD,L11,7AD,71,33,38,24
L11 7AE,L11,7AE,106,44,62,43
L11 7AF,L11,7AF,38,19,19,14
L11 7AG,L11,7AG,91,44,47,39
L11 7AH,L11,7AH,18,11,7,10
L11 7AJ,L11,7AJ,60,28,32,21
L11 7AL,L11,7AL,53,21,32,24
L11 7AN,L11,7AN,41,20,21,16
L11 7AP,L11,7AP,75,37,38,28
L11 7AQ,L11,7AQ,38,15,23,15
L11 7AR,L11,7AR,56,22,34,23
L11 7AS,L11,7AS,62,29,33,23
L11 7AT,L11,7AT,84,33,51,32
L11 7AU,L11,7AU,105,49,56,38
L11 7AW,L11,7AW,45,21,24,19
L11 7AX,L11,7AX,78,39,39,31
L11 7AY,L11,7AY,50,30,20,31
L11 7AZ,L11,7AZ,59,30,29,29
L11 7BA,L11,7BA,55,25,30,23
L11 7BB,L11,7BB,45,21,24,18
L11 7BE,L11,7BE,50,21,29,22
L11 7BG,L11,7BG,96,42,54,44
L11 7BH,L11,7BH,77,38,39,34
L11 7BJ,L11,7BJ,49,17,32,19
L11 7BL,L11,7BL,87,36,51,32
L11 7BN,L11,7BN,109,51,58,43
L11 7BP,L11,7BP,127,57,70,47
L11 7BQ,L11,7BQ,85,37,48,36
L11 7BR,L11,7BR,87,37,50,36
L11 7BS,L11,7BS,89,39,50,34
L11 7BT,L11,7BT,35,15,20,14
L11 7BU,L11,7BU,6,3,3,2
L11 7BW,L11,7BW,66,26,40,23
L11 7BX,L11,7BX,66,28,38,23
L11 7BY,L11,7BY,80,41,39,37
L11 7BZ,L11,7BZ,104,50,54,42
L11 7DA,L11,7DA,36,15,21,15
L11 7DB,L11,7DB,59,34,25,23
L11 7DD,L11,7DD,106,58,48,43
L11 7DE,L11,7DE,53,21,32,23
L11 7DF,L11,7DF,91,43,48,38
L11 7DG,L11,7DG,77,42,35,25
L11 7DH,L11,7DH,19,11,8,10
L11 7DJ,L11,7DJ,37,18,19,14
L11 7DL,L11,7DL,85,40,45,36
L11 7DN,L11,7DN,41,17,24,20
L11 7DQ,L11,7DQ,82,29,53,28
L11 7DR,L11,7DR,72,33,39,27
L11 7DS,L11,7DS,16,7,9,9
L11 7DU,L11,7DU,33,19,14,9
L11 7DW,L11,7DW,77,40,37,31
L11 8LA,L11,8LA,43,14,29,16
L11 8LB,L11,8LB,24,11,13,9
L11 8LD,L11,8LD,95,42,53,43
L11 8LE,L11,8LE,32,18,14,15
L11 8LF,L11,8LF,36,19,17,16
L11 8LG,L11,8LG,87,44,43,37
L11 8LH,L11,8LH,34,20,14,14
L11 8LJ,L11,8LJ,30,14,16,10
L11 8LL,L11,8LL,69,29,40,26
L11 8LN,L11,8LN,67,32,35,30
L11 8LP,L11,8LP,101,46,55,36
L11 8LQ,L11,8LQ,66,28,38,28
L11 8LR,L11,8LR,106,53,53,44
L11 8LS,L11,8LS,53,26,27,28
L11 8LT,L11,8LT,60,29,31,27
L11 8LU,L11,8LU,42,21,21,17
L11 8LW,L11,8LW,28,13,15,15
L11 8LX,L11,8LX,15,5,10,6
L11 8LY,L11,8LY,12,2,10,7
L11 8LZ,L11,8LZ,21,11,10,10
L11 8NA,L11,8NA,89,36,53,41
L11 8NB,L11,8NB,16,8,8,3
L11 8ND,L11,8ND,44,22,22,14
L11 8NE,L11,8NE,61,32,29,25
L11 8NF,L11,8NF,10,6,4,6
L11 8NG,L11,8NG,36,15,21,18
L11 8NH,L11,8NH,75,39,36,27
L11 8NJ,L11,8NJ,68,34,34,28
L11 8NL,L11,8NL,78,38,40,30
L11 8NN,L11,8NN,30,13,17,12
L11 8NP,L11,8NP,22,9,13,10
L11 8NQ,L11,8NQ,75,36,39,27
L11 8NR,L11,8NR,22,10,12,9
L11 8NS,L11,8NS,57,29,28,28
L11 8NT,L11,8NT,69,31,38,27
L11 8NU,L11,8NU,8,4,4,6
L11 8NW,L11,8NW,35,15,20,15
L11 8NX,L11,8NX,65,27,38,55
L11 9AA,L11,9AA,24,10,14,9
L11 9AB,L11,9AB,44,27,17,20
L11 9AD,L11,9AD,46,20,26,16
L11 9AE,L11,9AE,75,35,40,29
L11 9AF,L11,9AF,57,25,32,30
L11 9AG,L11,9AG,94,49,45,35
L11 9AH,L11,9AH,88,43,45,35
L11 9AJ,L11,9AJ,69,33,36,25
L11 9AL,L11,9AL,84,37,47,33
L11 9AN,L11,9AN,70,31,39,34
L11 9AP,L11,9AP,19,12,7,12
L11 9AQ,L11,9AQ,65,32,33,29
L11 9AS,L11,9AS,74,39,35,32
L11 9AT,L11,9AT,25,11,14,14
L11 9AU,L11,9AU,78,39,39,35
L11 9AW,L11,9AW,66,26,40,27
L11 9BR,L11,9BR,53,23,30,20
L11 9BS,L11,9BS,72,37,35,21
L11 9BT,L11,9BT,89,51,38,68
L11 9BU,L11,9BU,44,19,25,21
L11 9BX,L11,9BX,39,16,23,16
L11 9BY,L11,9BY,27,10,17,13
L11 9BZ,L11,9BZ,55,30,25,21
L11 9DE,L11,9DE,62,32,30,26
L11 9DF,L11,9DF,33,14,19,13
L11 9DG,L11,9DG,25,10,15,12
L11 9DJ,L11,9DJ,131,34,97,0
L11 9DP,L11,9DP,97,40,57,63
L11 9DR,L11,9DR,40,19,21,33
L11 9DT,L11,9DT,67,25,42,63
L11 9EA,L11,9EA,52,25,27,41
L11 9EB,L11,9EB,15,10,5,14
L12 0AA,L12,0AA,32,17,15,11
L12 0AB,L12,0AB,46,25,21,15
L12 0AD,L12,0AD,34,17,17,12
L12 0AE,L12,0AE,42,18,24,16
L12 0AF,L12,0AF,36,14,22,17
L12 0AG,L12,0AG,28,10,18,12
L12 0AJ,L12,0AJ,90,41,49,33
L12 0AL,L12,0AL,33,16,17,12
L12 0AP,L12,0AP,41,25,16,15
L12 0AR,L12,0AR,43,25,18,18
L12 0AT,L12,0AT,66,33,33,28
L12 0AU,L12,0AU,26,14,12,11
L12 0AW,L12,0AW,153,74,79,53
L12 0AX,L12,0AX,54,28,26,23
L12 0AY,L12,0AY,66,30,36,24
L12 0AZ,L12,0AZ,60,28,32,37
L12 0BA,L12,0BA,51,25,26,28
L12 0BB,L12,0BB,26,13,13,11
L12 0BD,L12,0BD,38,18,20,16
L12 0BE,L12,0BE,92,43,49,39
L12 0BG,L12,0BG,81,41,40,34
L12 0BH,L12,0BH,85,42,43,34
L12 0BJ,L12,0BJ,49,21,28,23
L12 0BL,L12,0BL,104,50,54,43
L12 0BP,L12,0BP,40,20,20,12
L12 0BQ,L12,0BQ,49,20,29,18
L12 0BR,L12,0BR,19,12,7,7
L12 0BS,L12,0BS,130,68,62,44
L12 0BW,L12,0BW,109,52,57,35
L12 0DF,L12,0DF,86,39,47,35
L12 0HA,L12,0HA,30,14,16,14
L12 0HD,L12,0HD,3,2,1,1
L12 0HE,L12,0HE,129,60,69,46
L12 0HF,L12,0HF,110,52,58,42
L12 0HG,L12,0HG,86,42,44,34
L12 0HH,L12,0HH,25,13,12,8
L12 0HJ,L12,0HJ,43,23,20,16
L12 0HL,L12,0HL,13,6,7,4
L12 0HN,L12,0HN,35,17,18,12
L12 0HP,L12,0HP,41,20,21,17
L12 0HQ,L12,0HQ,16,9,7,6
L12 0HR,L12,0HR,2,1,1,1
L12 0HS,L12,0HS,54,28,26,22
L12 0HT,L12,0HT,29,15,14,15
L12 0HU,L12,0HU,31,16,15,12
L12 0HW,L12,0HW,43,22,21,14
L12 0HX,L12,0HX,177,89,88,72
L12 0HY,L12,0HY,61,31,30,21
L12 0HZ,L12,0HZ,39,22,17,18
L12 0JB,L12,0JB,129,62,67,66
L12 0JD,L12,0JD,14,7,7,8
L12 0JF,L12,0JF,100,50,50,39
L12 0JG,L12,0JG,48,25,23,19
L12 0JH,L12,0JH,26,14,12,17
L12 0JJ,L12,0JJ,38,15,23,17
L12 0JL,L12,0JL,47,25,22,23
L12 0JN,L12,0JN,34,17,17,20
L12 0JP,L12,0JP,199,101,98,90
L12 0JQ,L12,0JQ,44,20,24,23
L12 0JR,L12,0JR,21,9,12,14
L12 0JS,L12,0JS,41,23,18,17
L12 0JT,L12,0JT,40,20,20,17
L12 0JU,L12,0JU,49,26,23,19
L12 0JW,L12,0JW,22,10,12,5
L12 0JX,L12,0JX,118,59,59,48
L12 0JY,L12,0JY,22,9,13,11
L12 0JZ,L12,0JZ,53,22,31,20
L12 0LA,L12,0LA,40,20,20,16
L12 0LB,L12,0LB,34,15,19,20
L12 0LD,L12,0LD,19,9,10,9
L12 0LE,L12,0LE,13,6,7,7
L12 0LF,L12,0LF,33,15,18,18
L12 0LG,L12,0LG,39,18,21,12
L12 0LH,L12,0LH,140,61,79,54
L12 0LJ,L12,0LJ,25,10,15,8
L12 0LL,L12,0LL,47,25,22,17
L12 0LN,L12,0LN,17,8,9,10
L12 0LP,L12,0LP,32,16,16,20
L12 0LQ,L12,0LQ,31,13,18,12
L12 0LR,L12,0LR,26,9,17,8
L12 0LS,L12,0LS,57,29,28,17
L12 0LT,L12,0LT,165,81,84,54
L12 0LU,L12,0LU,49,24,25,17
L12 0LW,L12,0LW,21,13,8,10
L12 0LX,L12,0LX,94,42,52,34
L12 0LY,L12,0LY,26,12,14,9
L12 0NA,L12,0NA,62,31,31,23
L12 0ND,L12,0ND,23,12,11,9
L12 0NF,L12,0NF,141,68,73,43
L12 0NG,L12,0NG,109,61,48,36
L12 0NH,L12,0NH,23,12,11,14
L12 0NJ,L12,0NJ,10,4,6,4
L12 0NL,L12,0NL,15,7,8,11
L12 0NN,L12,0NN,25,12,13,10
L12 0NP,L12,0NP,117,53,64,37
L12 0NR,L12,0NR,65,36,29,18
L12 0NS,L12,0NS,81,38,43,28
L12 0NT,L12,0NT,107,56,51,37
L12 0NU,L12,0NU,29,16,13,8
L12 0NW,L12,0NW,20,12,8,7
L12 0NX,L12,0NX,32,14,18,8
L12 0NY,L12,0NY,45,21,24,14
L12 0NZ,L12,0NZ,40,21,19,10
L12 0PA,L12,0PA,47,27,20,19
L12 0PB,L12,0PB,165,80,85,64
L12 0PD,L12,0PD,68,36,32,27
L12 0PE,L12,0PE,186,94,92,75
L12 0PF,L12,0PF,150,73,77,57
L12 0PG,L12,0PG,47,19,28,21
L12 0PH,L12,0PH,42,19,23,17
L12 0PL,L12,0PL,193,80,113,69
L12 0PN,L12,0PN,73,36,37,28
L12 0PP,L12,0PP,80,38,42,38
L12 0PQ,L12,0PQ,134,67,67,47
L12 0PR,L12,0PR,42,19,23,21
L12 0PS,L12,0PS,25,11,14,14
L12 0PT,L12,0PT,82,39,43,27
L12 0PW,L12,0PW,140,67,73,46
L12 0PX,L12,0PX,15,6,9,9
L12 0PY,L12,0PY,109,48,61,33
L12 0PZ,L12,0PZ,44,21,23,17
L12 0QA,L12,0QA,29,12,17,11
L12 0QB,L12,0QB,15,8,7,6
L12 0QD,L12,0QD,91,43,48,38
L12 0QE,L12,0QE,40,15,25,18
L12 0QF,L12,0QF,143,72,71,40
L12 0QG,L12,0QG,45,24,21,13
L12 0QH,L12,0QH,15,7,8,5
L12 0QJ,L12,0QJ,61,31,30,18
L12 0QL,L12,0QL,18,7,11,6
L12 0QN,L12,0QN,182,89,93,55
L12 0QP,L12,0QP,168,84,84,50
L12 0QQ,L12,0QQ,21,8,13,8
L12 0QR,L12,0QR,81,35,46,36
L12 0QS,L12,0QS,32,15,17,14
L12 0QU,L12,0QU,126,60,66,40
L12 0QW,L12,0QW,25,13,12,9
L12 0QY,L12,0QY,213,103,110,82
L12 0RJ,L12,0RJ,92,44,48,34
L12 0RL,L12,0RL,68,32,36,25
L12 0RN,L12,0RN,61,26,35,23
L12 0RP,L12,0RP,46,25,21,16
L12 0RQ,L12,0RQ,28,18,10,11
L12 0RR,L12,0RR,23,8,15,9
L12 0RS,L12,0RS,85,39,46,32
L12 0RT,L12,0RT,32,17,15,12
L12 0RU,L12,0RU,38,19,19,15
L12 0RW,L12,0RW,120,64,56,53
L12 0RX,L12,0RX,38,17,21,13
L12 0RY,L12,0RY,72,33,39,32
L12 0RZ,L12,0RZ,34,18,16,17
L12 0SA,L12,0SA,105,51,54,43
L12 0SB,L12,0SB,36,17,19,14
L12 0SD,L12,0SD,36,17,19,11
L12 0SE,L12,0SE,49,28,21,21
L12 0SF,L12,0SF,29,14,15,11
L12 0SG,L12,0SG,37,14,23,16
L12 0SN,L12,0SN,47,22,25,16
L12 0SQ,L12,0SQ,128,60,68,45
L12 0SX,L12,0SX,26,15,11,8
L12 1JY,L12,1JY,5,2,3,2
L12 1LA,L12,1LA,10,6,4,4
L12 1LB,L12,1LB,45,19,26,21
L12 1LD,L12,1LD,6,4,2,3
L12 1LE,L12,1LE,3,1,2,2
L12 1LF,L12,1LF,1,1,0,1
L12 1LG,L12,1LG,41,20,21,23
L12 1LH,L12,1LH,52,23,29,20
L12 1LJ,L12,1LJ,18,8,10,5
L12 1LL,L12,1LL,31,17,14,9
L12 1LN,L12,1LN,14,6,8,8
L12 1LP,L12,1LP,34,17,17,22
L12 1LQ,L12,1LQ,34,20,14,11
L12 1LR,L12,1LR,54,26,28,23
L12 1LS,L12,1LS,59,19,40,20
L12 1LT,L12,1LT,37,20,17,14
L12 1LU,L12,1LU,64,39,25,36
L12 1LW,L12,1LW,52,25,27,19
L12 1LX,L12,1LX,86,42,44,27
L12 1LY,L12,1LY,62,27,35,20
L12 1NA,L12,1NA,11,6,5,3
L12 1NB,L12,1NB,7,4,3,2
L12 1ND,L12,1ND,37,16,21,12
L12 1NE,L12,1NE,37,17,20,13
L12 1NF,L12,1NF,31,15,16,12
L12 1NH,L12,1NH,21,11,10,6
L12 2AD,L12,2AD,43,21,22,18
L12 2AE,L12,2AE,20,7,13,7
L12 2AF,L12,2AF,21,11,10,6
L12 2AG,L12,2AG,63,32,31,26
L12 2AH,L12,2AH,39,19,20,19
L12 2AJ,L12,2AJ,66,39,27,35
L12 2AL,L12,2AL,54,19,35,42
L12 2AN,L12,2AN,50,25,25,19
L12 2AQ,L12,2AQ,44,22,22,21
L12 2AR,L12,2AR,39,18,21,14
L12 2AS,L12,2AS,47,20,27,19
L12 2AT,L12,2AT,46,20,26,23
L12 2AU,L12,2AU,51,23,28,20
L12 2AW,L12,2AW,1,1,0,1
L12 2AX,L12,2AX,79,45,34,26
L12 2AY,L12,2AY,92,42,50,27
L12 2AZ,L12,2AZ,14,5,9,0
L12 2BA,L12,2BA,48,21,27,13
L12 2BB,L12,2BB,29,13,16,23
L12 2BD,L12,2BD,44,22,22,14
L12 2BJ,L12,2BJ,11,7,4,4
L12 2BL,L12,2BL,34,20,14,10
L12 3HA,L12,3HA,48,24,24,21
L12 3HB,L12,3HB,59,25,34,25
L12 3HD,L12,3HD,44,22,22,18
L12 3HE,L12,3HE,10,6,4,7
L12 3HH,L12,3HH,8,5,3,3
L12 3HJ,L12,3HJ,162,74,88,50
L12 3HL,L12,3HL,79,35,44,30
L12 3HN,L12,3HN,82,39,43,29
L12 3HP,L12,3HP,67,31,36,25
L12 3HQ,L12,3HQ,12,5,7,8
L12 3HR,L12,3HR,35,13,22,12
L12 3HS,L12,3HS,85,46,39,35
L12 3HU,L12,3HU,68,35,33,34
L12 3HW,L12,3HW,110,57,53,42
L12 4BA,L12,4BA,33,16,17,13
L12 4BB,L12,4BB,12,6,6,4
L12 4BD,L12,4BD,28,13,15,10
L12 4BE,L12,4BE,10,5,5,4
L12 4BF,L12,4BF,21,10,11,9
L12 4DA,L12,4DA,46,23,23,15
L12 4DB,L12,4DB,107,52,55,33
L12 4DD,L12,4DD,93,41,52,38
L12 4UZ,L12,4UZ,16,8,8,12
L12 4WT,L12,4WT,10,5,5,5
L12 4WU,L12,4WU,137,53,84,68
L12 4WX,L12,4WX,17,8,9,7
L12 4XA,L12,4XA,38,17,21,17
L12 4XB,L12,4XB,9,5,4,3
L12 4XD,L12,4XD,79,36,43,35
L12 4XE,L12,4XE,46,25,21,21
L12 4XF,L12,4XF,24,11,13,13
L12 4XG,L12,4XG,55,27,28,35
L12 4XH,L12,4XH,79,32,47,30
L12 4XJ,L12,4XJ,88,40,48,37
L12 4XL,L12,4XL,64,32,32,31
L12 4XN,L12,4XN,57,26,31,32
L12 4XR,L12,4XR,45,22,23,18
L12 4XS,L12,4XS,82,35,47,38
L12 4XT,L12,4XT,54,25,29,29
L12 4XU,L12,4XU,97,44,53,39
L12 4XW,L12,4XW,46,22,24,20
L12 4XX,L12,4XX,59,24,35,24
L12 4XY,L12,4XY,68,33,35,25
L12 4XZ,L12,4XZ,87,38,49,43
L12 4YA,L12,4YA,72,34,38,30
L12 4YB,L12,4YB,50,21,29,21
L12 4YD,L12,4YD,49,17,32,25
L12 4YE,L12,4YE,64,27,37,36
L12 4YF,L12,4YF,17,9,8,9
L12 4YG,L12,4YG,227,108,119,95
L12 4YJ,L12,4YJ,76,38,38,32
L12 4YL,L12,4YL,3,2,1,2
L12 4YN,L12,4YN,65,28,37,27
L12 4YP,L12,4YP,65,35,30,45
L12 4YQ,L12,4YQ,21,13,8,10
L12 4YR,L12,4YR,66,31,35,27
L12 4YS,L12,4YS,99,53,46,39
L12 4YT,L12,4YT,45,26,19,19
L12 4YU,L12,4YU,92,36,56,38
L12 4YW,L12,4YW,23,10,13,10
L12 4YX,L12,4YX,15,5,10,9
L12 4YZ,L12,4YZ,11,7,4,4
L12 4ZA,L12,4ZA,36,15,21,23
L12 4ZB,L12,4ZB,125,59,66,39
L12 4ZD,L12,4ZD,18,11,7,6
L12 4ZE,L12,4ZE,94,42,52,31
L12 4ZF,L12,4ZF,21,10,11,10
L12 4ZG,L12,4ZG,19,9,10,7
L12 4ZL,L12,4ZL,26,12,14,17
L12 4ZN,L12,4ZN,39,17,22,15
L12 5EA,L12,5EA,66,32,34,31
L12 5EB,L12,5EB,87,44,43,33
L12 5EE,L12,5EE,54,26,28,26
L12 5EF,L12,5EF,44,21,23,20
L12 5EG,L12,5EG,77,38,39,30
L12 5EH,L12,5EH,64,32,32,28
L12 5EJ,L12,5EJ,30,17,13,14
L12 5EL,L12,5EL,25,14,11,8
L12 5EN,L12,5EN,65,29,36,34
L12 5EP,L12,5EP,13,6,7,6
L12 5EQ,L12,5EQ,53,25,28,23
L12 5ER,L12,5ER,32,17,15,14
L12 5ES,L12,5ES,44,15,29,20
L12 5ET,L12,5ET,34,19,15,13
L12 5EU,L12,5EU,63,34,29,25
L12 5EW,L12,5EW,44,21,23,20
L12 5EX,L12,5EX,79,37,42,32
L12 5EY,L12,5EY,84,48,36,30
L12 5EZ,L12,5EZ,79,39,40,31
L12 5FB,L12,5FB,52,24,28,18
L12 5HA,L12,5HA,40,18,22,15
L12 5HB,L12,5HB,46,22,24,19
L12 5HD,L12,5HD,18,8,10,8
L12 5HE,L12,5HE,82,37,45,30
L12 5HF,L12,5HF,76,31,45,26
L12 5HG,L12,5HG,82,38,44,38
L12 5HH,L12,5HH,109,55,54,39
L12 5HJ,L12,5HJ,8,4,4,6
L12 5HP,L12,5HP,23,10,13,11
L12 5HQ,L12,5HQ,77,43,34,39
L12 5HR,L12,5HR,46,21,25,22
L12 5HS,L12,5HS,35,16,19,14
L12 5HT,L12,5HT,69,29,40,22
L12 5HU,L12,5HU,86,38,48,32
L12 5HW,L12,5HW,2,2,0,1
L12 5HX,L12,5HX,34,15,19,13
L12 5HY,L12,5HY,59,29,30,25
L12 5HZ,L12,5HZ,69,32,37,20
L12 5JA,L12,5JA,16,9,7,5
L12 5JB,L12,5JB,39,16,23,17
L12 5JD,L12,5JD,20,11,9,6
L12 5JE,L12,5JE,53,24,29,20
L12 5JF,L12,5JF,73,30,43,29
L12 5JG,L12,5JG,84,41,43,32
L12 5JH,L12,5JH,69,29,40,36
L12 5JJ,L12,5JJ,56,25,31,21
L12 5JL,L12,5JL,83,41,42,36
L12 5JN,L12,5JN,56,25,31,24
L12 5JP,L12,5JP,119,59,60,41
L12 5JQ,L12,5JQ,66,29,37,24
L12 5JR,L12,5JR,24,12,12,11
L12 5JS,L12,5JS,21,12,9,9
L12 5JT,L12,5JT,22,11,11,8
L12 5JU,L12,5JU,40,20,20,15
L12 5JW,L12,5JW,26,8,18,18
L12 5JX,L12,5JX,39,21,18,13
L12 5JY,L12,5JY,43,18,25,15
L12 5JZ,L12,5JZ,38,18,20,17
L12 5LB,L12,5LB,27,12,15,14
L12 5LD,L12,5LD,22,8,14,16
L12 5LE,L12,5LE,36,11,25,35
L12 5LS,L12,5LS,168,85,83,59
L12 5LT,L12,5LT,17,9,8,9
L12 5LX,L12,5LX,23,9,14,18
L12 5LZ,L12,5LZ,133,67,66,40
L12 5NA,L12,5NA,124,62,62,45
L12 5NE,L12,5NE,98,47,51,29
L12 5NH,L12,5NH,68,36,32,23
L12 6QA,L12,6QA,63,22,41,24
L12 6QB,L12,6QB,73,32,41,28
L12 6QD,L12,6QD,110,50,60,41
L12 6QE,L12,6QE,68,31,37,38
L12 6QF,L12,6QF,40,18,22,21
L12 6QG,L12,6QG,58,21,37,32
L12 6QH,L12,6QH,97,50,47,38
L12 6QJ,L12,6QJ,47,19,28,20
L12 6QL,L12,6QL,28,10,18,10
L12 6QN,L12,6QN,63,31,32,27
L12 6QP,L12,6QP,35,17,18,20
L12 6QQ,L12,6QQ,73,34,39,27
L12 6QR,L12,6QR,7,1,6,6
L12 6QS,L12,6QS,51,20,31,17
L12 6QT,L12,6QT,32,13,19,17
L12 6QU,L12,6QU,69,31,38,28
L12 6QW,L12,6QW,19,5,14,8
L12 6QX,L12,6QX,44,23,21,15
L12 6QY,L12,6QY,90,42,48,36
L12 6QZ,L12,6QZ,63,22,41,32
L12 6RA,L12,6RA,108,51,57,41
L12 6RB,L12,6RB,125,64,61,49
L12 6RD,L12,6RD,80,39,41,28
L12 6RE,L12,6RE,34,22,12,27
L12 6RF,L12,6RF,11,7,4,10
L12 6RG,L12,6RG,76,38,38,34
L12 6RH,L12,6RH,32,21,11,17
L12 6RJ,L12,6RJ,17,13,4,16
L12 6RL,L12,6RL,31,16,15,18
L12 6RN,L12,6RN,37,17,20,34
L12 6RP,L12,6RP,38,23,15,30
L12 6RQ,L12,6RQ,49,30,19,34
L12 6RR,L12,6RR,58,43,15,51
L12 6RS,L12,6RS,76,39,37,55
L12 6RW,L12,6RW,63,36,27,37
L12 6RY,L12,6RY,34,17,17,12
L12 7HA,L12,7HA,90,43,47,35
L12 7HB,L12,7HB,65,35,30,26
L12 7HD,L12,7HD,64,35,29,26
L12 7HE,L12,7HE,23,10,13,9
L12 7HF,L12,7HF,94,40,54,32
L12 7HG,L12,7HG,69,31,38,30
L12 7HH,L12,7HH,70,29,41,26
L12 7HJ,L12,7HJ,69,38,31,25
L12 7HL,L12,7HL,73,39,34,29
L12 7HN,L12,7HN,80,36,44,29
L12 7HP,L12,7HP,42,20,22,19
L12 7HQ,L12,7HQ,56,25,31,22
L12 7HR,L12,7HR,72,39,33,29
L12 7HS,L12,7HS,57,22,35,24
L12 7HT,L12,7HT,48,23,25,29
L12 7HU,L12,7HU,46,23,23,21
L12 7HW,L12,7HW,41,20,21,21
L12 7HX,L12,7HX,21,10,11,7
L12 7HZ,L12,7HZ,9,7,2,8
L12 7JA,L12,7JA,39,18,21,20
L12 7JB,L12,7JB,3,1,2,2
L12 7JD,L12,7JD,25,12,13,10
L12 7JF,L12,7JF,10,7,3,8
L12 7JG,L12,7JG,56,31,25,23
L12 7JH,L12,7JH,28,11,17,14
L12 7JJ,L12,7JJ,46,20,26,30
L12 7JL,L12,7JL,54,26,28,26
L12 7JN,L12,7JN,101,47,54,57
L12 7JP,L12,7JP,2,1,1,1
L12 7JQ,L12,7JQ,14,8,6,5
L12 7JR,L12,7JR,49,18,31,32
L12 7JS,L12,7JS,31,13,18,13
L12 7JT,L12,7JT,69,27,42,25
L12 7JU,L12,7JU,71,34,37,26
L12 7JW,L12,7JW,23,9,14,10
L12 7JY,L12,7JY,82,38,44,33
L12 7JZ,L12,7JZ,82,40,42,36
L12 7LA,L12,7LA,38,19,19,26
L12 7LB,L12,7LB,31,14,17,12
L12 7LD,L12,7LD,23,9,14,12
L12 7LG,L12,7LG,42,21,21,20
L12 7LH,L12,7LH,48,25,23,16
L12 7LJ,L12,7LJ,82,30,52,44
L12 7LL,L12,7LL,10,3,7,9
L12 7LQ,L12,7LQ,12,7,5,5
L12 7LR,L12,7LR,96,50,46,41
L12 7LS,L12,7LS,58,24,34,29
L12 7LT,L12,7LT,105,47,58,38
L12 7LW,L12,7LW,43,21,22,17
L12 7NA,L12,7NA,7,4,3,6
L12 8QA,L12,8QA,52,25,27,25
L12 8QB,L12,8QB,50,25,25,24
L12 8QD,L12,8QD,65,28,37,25
L12 8QF,L12,8QF,77,32,45,38
L12 8QG,L12,8QG,61,26,35,25
L12 8QH,L12,8QH,55,25,30,31
L12 8QJ,L12,8QJ,39,16,23,18
L12 8QL,L12,8QL,55,29,26,18
L12 8QN,L12,8QN,78,35,43,34
L12 8QP,L12,8QP,32,14,18,19
L12 8QQ,L12,8QQ,54,22,32,26
L12 8QR,L12,8QR,106,53,53,39
L12 8QS,L12,8QS,40,22,18,19
L12 8QT,L12,8QT,77,32,45,25
L12 8QU,L12,8QU,50,29,21,18
L12 8QW,L12,8QW,65,32,33,32
L12 8QX,L12,8QX,117,52,65,38
L12 8QY,L12,8QY,53,25,28,30
L12 8QZ,L12,8QZ,59,28,31,33
L12 8RA,L12,8RA,105,57,48,33
L12 8RB,L12,8RB,114,50,64,45
L12 8RD,L12,8RD,128,68,60,46
L12 8RE,L12,8RE,26,16,10,12
L12 8RF,L12,8RF,45,19,26,20
L12 8RG,L12,8RG,30,14,16,16
L12 8RH,L12,8RH,128,59,69,47
L12 8RJ,L12,8RJ,42,17,25,18
L12 8RL,L12,8RL,85,37,48,39
L12 8RN,L12,8RN,81,37,44,36
L12 8RP,L12,8RP,47,26,21,19
L12 8RQ,L12,8RQ,17,8,9,8
L12 8RR,L12,8RR,105,52,53,43
L12 8RS,L12,8RS,38,17,21,14
L12 8RT,L12,8RT,96,57,39,32
L12 8RU,L12,8RU,62,30,32,26
L12 8RW,L12,8RW,84,39,45,40
L12 8RX,L12,8RX,23,12,11,10
L12 8RY,L12,8RY,31,12,19,13
L12 8RZ,L12,8RZ,96,49,47,39
L12 8SA,L12,8SA,5,2,3,4
L12 8SJ,L12,8SJ,26,14,12,13
L12 8SL,L12,8SL,7,5,2,5
L12 8SN,L12,8SN,42,15,27,29
L12 8SP,L12,8SP,10,3,7,5
L12 8SR,L12,8SR,124,63,61,45
L12 8SU,L12,8SU,6,2,4,4
L12 8SW,L12,8SW,9,3,6,4
L12 8TH,L12,8TH,14,9,5,13
L12 8TQ,L12,8TQ,53,21,32,35
L12 9EA,L12,9EA,77,33,44,32
L12 9EB,L12,9EB,39,19,20,33
L12 9ED,L12,9ED,88,47,41,35
L12 9EE,L12,9EE,68,34,34,26
L12 9EF,L12,9EF,62,26,36,25
L12 9EG,L12,9EG,52,30,22,17
L12 9EH,L12,9EH,105,51,54,42
L12 9EJ,L12,9EJ,120,54,66,41
L12 9EL,L12,9EL,92,46,46,37
L12 9EN,L12,9EN,45,19,26,19
L12 9EP,L12,9EP,64,33,31,22
L12 9EQ,L12,9EQ,102,53,49,43
L12 9ER,L12,9ER,41,21,20,15
L12 9ES,L12,9ES,98,41,57,35
L12 9ET,L12,9ET,52,23,29,22
L12 9EU,L12,9EU,85,35,50,35
L12 9EW,L12,9EW,42,23,19,17
L12 9EX,L12,9EX,121,61,60,43
L12 9EY,L12,9EY,33,19,14,14
L12 9EZ,L12,9EZ,71,33,38,28
L12 9GY,L12,9GY,11,4,7,8
L12 9HA,L12,9HA,58,31,27,23
L12 9HB,L12,9HB,63,34,29,23
L12 9HD,L12,9HD,33,14,19,14
L12 9HE,L12,9HE,59,26,33,27
L12 9HF,L12,9HF,64,30,34,27
L12 9HG,L12,9HG,67,33,34,29
L12 9HH,L12,9HH,12,2,10,2
L12 9HL,L12,9HL,20,9,11,8
L12 9HP,L12,9HP,9,6,3,3
L12 9HQ,L12,9HQ,49,24,25,18
L12 9HR,L12,9HR,36,16,20,14
L12 9HS,L12,9HS,14,7,7,5
L12 9HU,L12,9HU,80,42,38,26
L12 9HW,L12,9HW,97,47,50,42
L12 9HX,L12,9HX,70,35,35,26
L12 9HY,L12,9HY,21,3,18,1
L12 9JA,L12,9JA,27,12,15,11
L12 9JB,L12,9JB,48,21,27,18
L12 9JD,L12,9JD,65,30,35,20
L12 9JE,L12,9JE,103,55,48,39
L12 9JF,L12,9JF,44,22,22,16
L12 9JG,L12,9JG,63,34,29,24
L12 9JJ,L12,9JJ,39,9,30,36
L12 9JL,L12,9JL,20,9,11,8
L12 9JN,L12,9JN,18,6,12,13
L12 9JQ,L12,9JQ,85,40,45,36
L12 9JR,L12,9JR,134,64,70,70
L12 9JS,L12,9JS,54,31,23,34
L12 9JT,L12,9JT,72,28,44,41
L12 9JU,L12,9JU,16,7,9,8
L12 9JX,L12,9JX,9,5,4,5
L12 9JY,L12,9JY,158,73,85,62
L12 9JZ,L12,9JZ,51,25,26,21
L12 9LA,L12,9LA,37,20,17,11
L12 9LB,L12,9LB,71,35,36,25
L12 9LD,L12,9LD,38,19,19,14
L12 9LE,L12,9LE,42,23,19,15
L12 9LJ,L12,9LJ,110,45,65,39
L12 9LL,L12,9LL,15,7,8,6
L12 9LN,L12,9LN,28,16,12,12
L12 9LP,L12,9LP,37,15,22,16
L12 9LQ,L12,9LQ,45,23,22,14
L12 9LR,L12,9LR,21,10,11,6
L12 9LS,L12,9LS,110,53,57,46
L12 9LT,L12,9LT,61,30,31,22
L12 9LU,L12,9LU,113,55,58,46
L12 9LW,L12,9LW,36,17,19,15
L12 9LX,L12,9LX,42,17,25,20
L12 9LY,L12,9LY,35,18,17,12
L12 9LZ,L12,9LZ,26,14,12,13
L12 9NA,L12,9NA,26,12,14,10
L12 9NB,L12,9NB,27,10,17,8
L12 9ND,L12,9ND,48,23,25,19
L12 9NE,L12,9NE,38,17,21,13
L12 9NF,L12,9NF,70,39,31,45
L12 9NW,L12,9NW,158,79,79,54
L13 0AA,L13,0AA,80,38,42,37
L13 0AB,L13,0AB,76,36,40,29
L13 0AD,L13,0AD,75,29,46,33
L13 0AF,L13,0AF,25,15,10,11
L13 0AG,L13,0AG,65,32,33,23
L13 0AH,L13,0AH,57,23,34,24
L13 0AJ,L13,0AJ,64,30,34,22
L13 0AL,L13,0AL,52,29,23,19
L13 0AP,L13,0AP,30,15,15,11
L13 0AQ,L13,0AQ,81,43,38,30
L13 0AR,L13,0AR,5,4,1,2
L13 0AS,L13,0AS,87,47,40,35
L13 0AT,L13,0AT,58,35,23,21
L13 0AU,L13,0AU,23,13,10,10
L13 0AW,L13,0AW,68,31,37,31
L13 0AX,L13,0AX,70,36,34,28
L13 0AY,L13,0AY,54,22,32,22
L13 0AZ,L13,0AZ,89,45,44,34
L13 0BA,L13,0BA,31,16,15,15
L13 0BB,L13,0BB,44,25,19,20
L13 0BD,L13,0BD,53,30,23,20
L13 0BG,L13,0BG,41,20,21,16
L13 0BH,L13,0BH,52,26,26,22
L13 0BJ,L13,0BJ,47,21,26,21
L13 0BL,L13,0BL,65,32,33,31
L13 0BN,L13,0BN,79,40,39,38
L13 0BP,L13,0BP,59,29,30,37
L13 0BR,L13,0BR,62,32,30,32
L13 0BT,L13,0BT,91,42,49,41
L13 0BU,L13,0BU,99,44,55,41
L13 0BX,L13,0BX,68,30,38,26
L13 0BY,L13,0BY,28,15,13,10
L13 0BZ,L13,0BZ,94,42,52,38
L13 0DA,L13,0DA,15,9,6,4
L13 0DB,L13,0DB,64,26,38,28
L13 0DD,L13,0DD,35,20,15,12
L13 0DE,L13,0DE,19,10,9,8
L13 0DF,L13,0DF,56,25,31,43
L13 0DL,L13,0DL,2,0,2,1
L13 0DQ,L13,0DQ,23,11,12,18
L13 1AA,L13,1AA,34,12,22,14
L13 1BA,L13,1BA,6,4,2,6
L13 1BB,L13,1BB,23,10,13,6
L13 1BE,L13,1BE,39,22,17,18
L13 1BN,L13,1BN,50,23,27,25
L13 1BP,L13,1BP,91,50,41,47
L13 1BR,L13,1BR,13,6,7,7
L13 1BS,L13,1BS,103,49,54,48
L13 1BW,L13,1BW,15,8,7,12
L13 1DB,L13,1DB,5,4,1,4
L13 1DD,L13,1DD,55,28,27,30
L13 1DF,L13,1DF,53,28,25,27
L13 1DG,L13,1DG,167,66,101,34
L13 1DJ,L13,1DJ,87,46,41,53
L13 1DL,L13,1DL,120,54,66,44
L13 1DN,L13,1DN,22,9,13,14
L13 1DP,L13,1DP,28,22,6,24
L13 1DQ,L13,1DQ,44,25,19,24
L13 1DR,L13,1DR,40,19,21,20
L13 1DS,L13,1DS,52,25,27,25
L13 1DT,L13,1DT,68,27,41,33
L13 1DU,L13,1DU,95,44,51,38
L13 1DW,L13,1DW,55,33,22,29
L13 1EB,L13,1EB,65,30,35,27
L13 1ED,L13,1ED,22,9,13,12
L13 1EH,L13,1EH,3,1,2,1
L13 1EJ,L13,1EJ,2,2,0,1
L13 1EQ,L13,1EQ,46,21,25,20
L13 1EZ,L13,1EZ,81,35,46,29
L13 1HW,L13,1HW,2,0,2,2
L13 2AA,L13,2AA,85,44,41,44
L13 2AB,L13,2AB,76,33,43,49
L13 2AD,L13,2AD,99,43,56,39
L13 2AE,L13,2AE,40,16,24,23
L13 2AG,L13,2AG,76,39,37,46
L13 2AH,L13,2AH,101,49,52,39
L13 2AJ,L13,2AJ,43,17,26,18
L13 2AL,L13,2AL,82,36,46,37
L13 2AN,L13,2AN,65,29,36,32
L13 2AP,L13,2AP,79,33,46,25
L13 2AQ,L13,2AQ,76,39,37,41
L13 2AR,L13,2AR,89,49,40,35
L13 2AS,L13,2AS,62,28,34,31
L13 2AT,L13,2AT,65,33,32,29
L13 2AU,L13,2AU,91,47,44,32
L13 2AW,L13,2AW,96,47,49,39
L13 2AY,L13,2AY,91,43,48,38
L13 2BA,L13,2BA,86,50,36,29
L13 2BD,L13,2BD,96,44,52,47
L13 2BE,L13,2BE,17,7,10,8
L13 2BG,L13,2BG,22,9,13,10
L13 2BH,L13,2BH,59,27,32,27
L13 2BJ,L13,2BJ,60,35,25,25
L13 2BL,L13,2BL,67,31,36,27
L13 2BN,L13,2BN,135,53,82,61
L13 2BP,L13,2BP,64,29,35,34
L13 2BQ,L13,2BQ,39,19,20,20
L13 2BR,L13,2BR,77,30,47,34
L13 2BS,L13,2BS,67,31,36,28
L13 2BT,L13,2BT,118,61,57,50
L13 2BU,L13,2BU,73,28,45,31
L13 2BW,L13,2BW,75,38,37,31
L13 2BX,L13,2BX,19,8,11,9
L13 2DA,L13,2DA,73,32,41,32
L13 2DF,L13,2DF,9,5,4,6
L13 2DJ,L13,2DJ,57,24,33,25
L13 2DN,L13,2DN,19,9,10,10
L13 2DP,L13,2DP,60,32,28,28
L13 2DR,L13,2DR,51,20,31,20
L13 2DS,L13,2DS,83,40,43,47
L13 2DU,L13,2DU,67,36,31,26
L13 2DW,L13,2DW,61,30,31,20
L13 2DX,L13,2DX,24,5,19,11
L13 2DY,L13,2DY,102,64,38,77
L13 2EL,L13,2EL,44,22,22,23
L13 2GA,L13,2GA,4,3,1,3
L13 2HF,L13,2HF,23,11,12,13
L13 2HQ,L13,2HQ,29,15,14,17
L13 3AD,L13,3AD,9,2,7,4
L13 3AE,L13,3AE,35,18,17,23
L13 3AL,L13,3AL,91,39,52,49
L13 3AP,L13,3AP,4,4,0,4
L13 3AU,L13,3AU,42,21,21,16
L13 3AX,L13,3AX,40,20,20,16
L13 3AY,L13,3AY,43,18,25,16
L13 3AZ,L13,3AZ,34,15,19,15
L13 3BA,L13,3BA,47,16,31,15
L13 3BB,L13,3BB,55,26,29,20
L13 3BD,L13,3BD,72,34,38,33
L13 3BE,L13,3BE,50,22,28,32
L13 3BG,L13,3BG,45,23,22,16
L13 3BJ,L13,3BJ,122,49,73,41
L13 3BL,L13,3BL,26,10,16,9
L13 3BN,L13,3BN,128,73,55,71
L13 3BP,L13,3BP,41,18,23,15
L13 3BQ,L13,3BQ,68,27,41,29
L13 3BR,L13,3BR,101,45,56,45
L13 3BS,L13,3BS,13,9,4,9
L13 3BT,L13,3BT,20,9,11,11
L13 3BU,L13,3BU,1,1,0,1
L13 3DA,L13,3DA,80,66,14,21
L13 3DB,L13,3DB,30,23,7,22
L13 3DE,L13,3DE,2,1,1,2
L13 3DG,L13,3DG,64,26,38,26
L13 3DH,L13,3DH,82,40,42,36
L13 3DJ,L13,3DJ,20,10,10,12
L13 3DL,L13,3DL,33,18,15,16
L13 3DN,L13,3DN,34,20,14,15
L13 3DP,L13,3DP,84,40,44,32
L13 3DR,L13,3DR,55,27,28,19
L13 3DS,L13,3DS,97,39,58,44
L13 3DT,L13,3DT,59,31,28,23
L13 3DU,L13,3DU,89,36,53,38
L13 3DW,L13,3DW,31,16,15,17
L13 3DX,L13,3DX,108,54,54,43
L13 3DY,L13,3DY,128,64,64,52
L13 3DZ,L13,3DZ,102,44,58,48
L13 3EA,L13,3EA,87,43,44,34
L13 3EB,L13,3EB,78,37,41,37
L13 3ED,L13,3ED,43,18,25,17
L13 3EE,L13,3EE,67,31,36,27
L13 3EF,L13,3EF,115,55,60,42
L13 3EG,L13,3EG,133,62,71,52
L13 3EH,L13,3EH,65,29,36,28
L13 3EL,L13,3EL,45,18,27,16
L13 3EQ,L13,3EQ,85,48,37,39
L13 3EW,L13,3EW,28,14,14,27
L13 3HT,L13,3HT,108,54,54,41
L13 4AA,L13,4AA,115,57,58,55
L13 4AB,L13,4AB,100,49,51,39
L13 4AD,L13,4AD,60,26,34,23
L13 4AE,L13,4AE,71,28,43,28
L13 4AF,L13,4AF,65,30,35,29
L13 4AH,L13,4AH,42,26,16,24
L13 4AP,L13,4AP,81,34,47,32
L13 4AR,L13,4AR,13,7,6,6
L13 4AS,L13,4AS,69,32,37,27
L13 4AU,L13,4AU,23,10,13,10
L13 4AW,L13,4AW,49,37,12,0
L13 4AX,L13,4AX,21,9,12,11
L13 4AY,L13,4AY,120,59,61,43
L13 4AZ,L13,4AZ,54,27,27,23
L13 4BA,L13,4BA,90,45,45,53
L13 4BB,L13,4BB,56,34,22,45
L13 4BD,L13,4BD,53,36,17,43
L13 4BE,L13,4BE,105,56,49,62
L13 4BG,L13,4BG,123,67,56,45
L13 4BH,L13,4BH,76,35,41,28
L13 4BJ,L13,4BJ,45,26,19,16
L13 4BL,L13,4BL,61,32,29,25
L13 4BN,L13,4BN,68,32,36,27
L13 4BP,L13,4BP,101,33,68,27
L13 4BQ,L13,4BQ,47,24,23,20
L13 4BR,L13,4BR,33,16,17,12
L13 4BS,L13,4BS,49,26,23,22
L13 4BT,L13,4BT,6,3,3,3
L13 4BW,L13,4BW,108,62,46,43
L13 4BX,L13,4BX,88,45,43,55
L13 4BY,L13,4BY,63,39,24,38
L13 4BZ,L13,4BZ,70,49,21,61
L13 4DA,L13,4DA,50,21,29,23
L13 4DB,L13,4DB,102,52,50,38
L13 4DD,L13,4DD,45,22,23,18
L13 4DE,L13,4DE,81,42,39,29
L13 4DF,L13,4DF,63,33,30,24
L13 4DG,L13,4DG,91,39,52,32
L13 4DH,L13,4DH,124,55,69,42
L13 4DJ,L13,4DJ,86,38,48,38
L13 4DN,L13,4DN,37,20,17,19
L13 4DP,L13,4DP,87,42,45,37
L13 4DQ,L13,4DQ,71,38,33,30
L13 4DR,L13,4DR,13,6,7,6
L13 4DU,L13,4DU,32,22,10,25
L13 4DW,L13,4DW,90,41,49,41
L13 4DX,L13,4DX,18,10,8,13
L13 5RL,L13,5RL,35,9,26,13
L13 5RN,L13,5RN,58,22,36,49
L13 5RR,L13,5RR,52,24,28,20
L13 5SA,L13,5SA,3,2,1,2
L13 5SB,L13,5SB,28,22,6,24
L13 5SD,L13,5SD,47,26,21,19
L13 5SE,L13,5SE,51,24,27,20
L13 5SF,L13,5SF,54,27,27,24
L13 5SG,L13,5SG,6,3,3,2
L13 5SH,L13,5SH,88,41,47,27
L13 5SL,L13,5SL,79,38,41,31
L13 5SN,L13,5SN,32,16,16,19
L13 5SP,L13,5SP,106,54,52,43
L13 5SR,L13,5SR,73,30,43,44
L13 5SS,L13,5SS,94,49,45,54
L13 5ST,L13,5ST,98,40,58,47
L13 5SU,L13,5SU,90,37,53,37
L13 5SW,L13,5SW,76,32,44,47
L13 5SX,L13,5SX,83,37,46,37
L13 5SY,L13,5SY,150,72,78,83
L13 5TA,L13,5TA,28,13,15,15
L13 5TB,L13,5TB,61,34,27,34
L13 5TE,L13,5TE,36,16,20,19
L13 5TF,L13,5TF,69,33,36,28
L13 5TJ,L13,5TJ,40,17,23,18
L13 5TL,L13,5TL,71,31,40,37
L13 5TP,L13,5TP,62,29,33,30
L13 5TR,L13,5TR,68,38,30,28
L13 5TS,L13,5TS,60,31,29,24
L13 5TT,L13,5TT,11,9,2,9
L13 5TU,L13,5TU,109,52,57,41
L13 5TX,L13,5TX,47,21,26,21
L13 5TY,L13,5TY,78,43,35,25
L13 5TZ,L13,5TZ,49,26,23,22
L13 5UA,L13,5UA,22,12,10,14
L13 5UB,L13,5UB,94,47,47,38
L13 5UD,L13,5UD,78,37,41,29
L13 5UE,L13,5UE,89,50,39,37
L13 5UF,L13,5UF,91,43,48,43
L13 5UG,L13,5UG,82,36,46,34
L13 5UH,L13,5UH,94,44,50,42
L13 5UJ,L13,5UJ,73,27,46,32
L13 5UL,L13,5UL,120,56,64,42
L13 5UN,L13,5UN,61,26,35,33
L13 5UP,L13,5UP,106,47,59,44
L13 5UR,L13,5UR,2,1,1,1
L13 5UW,L13,5UW,74,31,43,37
L13 5XA,L13,5XA,6,3,3,2
L13 5XD,L13,5XD,44,26,18,24
L13 5XE,L13,5XE,5,1,4,2
L13 5XG,L13,5XG,2,0,2,1
L13 5XH,L13,5XH,63,32,31,26
L13 5XJ,L13,5XJ,110,55,55,41
L13 5XL,L13,5XL,59,27,32,27
L13 5XN,L13,5XN,80,35,45,29
L13 5XP,L13,5XP,61,27,34,28
L13 5XR,L13,5XR,1,0,1,1
L13 5XS,L13,5XS,65,27,38,34
L13 5XT,L13,5XT,88,33,55,47
L13 5XU,L13,5XU,63,31,32,33
L13 5XW,L13,5XW,99,49,50,42
L13 5XX,L13,5XX,71,37,34,25
L13 5XY,L13,5XY,71,33,38,36
L13 5XZ,L13,5XZ,97,40,57,55
L13 5YA,L13,5YA,65,29,36,37
L13 5YB,L13,5YB,92,44,48,46
L13 5YD,L13,5YD,92,48,44,36
L13 5YE,L13,5YE,73,32,41,32
L13 5YF,L13,5YF,79,35,44,30
L13 5YG,L13,5YG,33,27,6,29
L13 5YH,L13,5YH,12,9,3,12
L13 5YQ,L13,5YQ,29,24,5,28
L13 5YZ,L13,5YZ,29,11,18,0
L13 6QA,L13,6QA,32,16,16,17
L13 6QD,L13,6QD,82,37,45,35
L13 6QE,L13,6QE,36,21,15,18
L13 6QF,L13,6QF,54,28,26,23
L13 6QH,L13,6QH,81,35,46,30
L13 6QJ,L13,6QJ,66,30,36,27
L13 6QL,L13,6QL,69,32,37,28
L13 6QN,L13,6QN,110,51,59,41
L13 6QP,L13,6QP,146,83,63,73
L13 6QQ,L13,6QQ,59,26,33,26
L13 6QR,L13,6QR,71,32,39,33
L13 6QS,L13,6QS,60,23,37,30
L13 6QT,L13,6QT,64,35,29,29
L13 6QU,L13,6QU,116,58,58,48
L13 6QW,L13,6QW,75,36,39,30
L13 6QX,L13,6QX,41,13,28,16
L13 6QY,L13,6QY,27,13,14,19
L13 6QZ,L13,6QZ,88,45,43,41
L13 6RA,L13,6RA,39,20,19,12
L13 6RB,L13,6RB,98,46,52,40
L13 6RD,L13,6RD,29,14,15,13
L13 6RE,L13,6RE,45,20,25,30
L13 6RF,L13,6RF,17,8,9,11
L13 6RH,L13,6RH,7,3,4,3
L13 6RJ,L13,6RJ,16,9,7,8
L13 6RL,L13,6RL,118,63,55,52
L13 6RN,L13,6RN,99,55,44,34
L13 6RP,L13,6RP,36,14,22,14
L13 6RQ,L13,6RQ,43,24,19,17
L13 6RR,L13,6RR,146,68,78,54
L13 6RS,L13,6RS,73,34,39,30
L13 6RT,L13,6RT,107,54,53,40
L13 6RU,L13,6RU,107,54,53,39
L13 6RW,L13,6RW,71,37,34,25
L13 6RX,L13,6RX,62,33,29,28
L13 6RY,L13,6RY,97,54,43,35
L13 6RZ,L13,6RZ,113,58,55,42
L13 6SA,L13,6SA,37,23,14,20
L13 6SB,L13,6SB,58,28,30,27
L13 6SD,L13,6SD,89,40,49,39
L13 6SE,L13,6SE,113,61,52,48
L13 6SF,L13,6SF,72,35,37,28
L13 6SG,L13,6SG,74,34,40,32
L13 6SH,L13,6SH,110,49,61,44
L13 6SJ,L13,6SJ,89,42,47,33
L13 6SQ,L13,6SQ,103,55,48,39
L13 6TA,L13,6TA,67,28,39,28
L13 7BA,L13,7BA,27,12,15,10
L13 7BB,L13,7BB,32,18,14,17
L13 7BE,L13,7BE,74,37,37,31
L13 7BG,L13,7BG,89,42,47,35
L13 7BH,L13,7BH,75,33,42,32
L13 7BJ,L13,7BJ,85,40,45,28
L13 7BL,L13,7BL,8,4,4,3
L13 7BN,L13,7BN,71,38,33,31
L13 7BP,L13,7BP,33,17,16,8
L13 7BR,L13,7BR,69,32,37,31
L13 7BS,L13,7BS,92,38,54,36
L13 7BT,L13,7BT,111,53,58,42
L13 7BU,L13,7BU,78,51,27,45
L13 7BW,L13,7BW,96,45,51,35
L13 7BX,L13,7BX,64,41,23,27
L13 7BY,L13,7BY,74,49,25,49
L13 7BZ,L13,7BZ,67,48,19,38
L13 7DA,L13,7DA,53,32,21,22
L13 7DD,L13,7DD,9,5,4,2
L13 7DE,L13,7DE,63,32,31,19
L13 7DF,L13,7DF,53,28,25,18
L13 7DG,L13,7DG,55,37,18,28
L13 7DH,L13,7DH,59,31,28,23
L13 7DJ,L13,7DJ,42,26,16,23
L13 7DL,L13,7DL,98,53,45,53
L13 7DN,L13,7DN,62,31,31,20
L13 7DP,L13,7DP,54,31,23,20
L13 7DQ,L13,7DQ,60,38,22,33
L13 7DR,L13,7DR,15,7,8,11
L13 7DS,L13,7DS,18,8,10,12
L13 7DT,L13,7DT,30,21,9,7
L13 7EA,L13,7EA,56,24,32,23
L13 7EB,L13,7EB,48,14,34,1
L13 7EE,L13,7EE,55,29,26,26
L13 7EF,L13,7EF,28,8,20,13
L13 7EG,L13,7EG,66,32,34,32
L13 7EH,L13,7EH,104,51,53,42
L13 7EJ,L13,7EJ,44,21,23,23
L13 7EL,L13,7EL,40,19,21,18
L13 7EN,L13,7EN,100,46,54,47
L13 7EP,L13,7EP,57,27,30,27
L13 7EQ,L13,7EQ,27,11,16,12
L13 7ER,L13,7ER,101,54,47,45
L13 7ES,L13,7ES,113,47,66,44
L13 7ET,L13,7ET,132,59,73,45
L13 7EW,L13,7EW,47,19,28,21
L13 7EX,L13,7EX,48,25,23,28
L13 7EY,L13,7EY,107,47,60,42
L13 7EZ,L13,7EZ,130,70,60,53
L13 7FB,L13,7FB,22,12,10,9
L13 7FG,L13,7FG,19,11,8,10
L13 7GA,L13,7GA,29,15,14,16
L13 7GB,L13,7GB,7,4,3,4
L13 7HA,L13,7HA,77,37,40,30
L13 7HB,L13,7HB,122,60,62,46
L13 7HD,L13,7HD,17,10,7,10
L13 7HE,L13,7HE,9,4,5,3
L13 7HF,L13,7HF,11,7,4,7
L13 7HG,L13,7HG,14,8,6,5
L13 7HH,L13,7HH,2,2,0,2
L13 7HN,L13,7HN,73,55,18,62
L13 7HQ,L13,7HQ,6,3,3,4
L13 7HU,L13,7HU,55,29,26,27
L13 7HW,L13,7HW,67,55,12,60
L13 7HX,L13,7HX,31,19,12,26
L13 7HZ,L13,7HZ,33,19,14,12
L13 8AA,L13,8AA,21,16,5,12
L13 8AD,L13,8AD,1,1,0,1
L13 8AE,L13,8AE,8,3,5,3
L13 8AG,L13,8AG,5,3,2,4
L13 8AJ,L13,8AJ,6,4,2,1
L13 8AL,L13,8AL,88,53,35,52
L13 8AP,L13,8AP,35,19,16,16
L13 8AR,L13,8AR,54,26,28,25
L13 8AS,L13,8AS,69,37,32,31
L13 8AT,L13,8AT,67,39,28,34
L13 8AU,L13,8AU,68,33,35,27
L13 8AW,L13,8AW,101,55,46,42
L13 8AX,L13,8AX,39,21,18,22
L13 8AY,L13,8AY,104,60,44,53
L13 8AZ,L13,8AZ,104,53,51,34
L13 8BA,L13,8BA,73,41,32,28
L13 8BB,L13,8BB,160,74,86,67
L13 8BD,L13,8BD,95,48,47,42
L13 8BG,L13,8BG,68,35,33,33
L13 8BJ,L13,8BJ,95,39,56,41
L13 8BL,L13,8BL,83,36,47,37
L13 8BN,L13,8BN,73,37,36,30
L13 8BP,L13,8BP,67,28,39,30
L13 8BQ,L13,8BQ,94,41,53,37
L13 8BR,L13,8BR,75,31,44,28
L13 8BS,L13,8BS,63,26,37,28
L13 8BT,L13,8BT,84,44,40,31
L13 8BU,L13,8BU,41,22,19,20
L13 8BW,L13,8BW,82,37,45,34
L13 8BX,L13,8BX,57,31,26,17
L13 8BY,L13,8BY,59,34,25,25
L13 8DA,L13,8DA,33,18,15,16
L13 8DB,L13,8DB,89,43,46,43
L13 8DD,L13,8DD,54,29,25,35
L13 8DE,L13,8DE,49,28,21,22
L13 8DF,L13,8DF,64,27,37,31
L13 8DG,L13,8DG,20,8,12,9
L13 8DH,L13,8DH,127,67,60,44
L13 8DJ,L13,8DJ,20,11,9,8
L13 8DL,L13,8DL,93,50,43,43
L13 8DN,L13,8DN,81,42,39,37
L13 8DP,L13,8DP,89,38,51,42
L13 8DR,L13,8DR,72,33,39,30
L13 8DS,L13,8DS,75,40,35,29
L13 8DT,L13,8DT,39,12,27,20
L13 8DU,L13,8DU,75,37,38,46
L13 8DW,L13,8DW,96,45,51,48
L13 8DX,L13,8DX,59,31,28,39
L13 8DY,L13,8DY,28,13,15,13
L13 8DZ,L13,8DZ,50,30,20,23
L13 8EA,L13,8EA,109,48,61,42
L13 8ED,L13,8ED,74,38,36,32
L13 8EF,L13,8EF,24,23,1,23
L13 8EN,L13,8EN,9,4,5,4
L13 9AA,L13,9AA,120,51,69,48
L13 9AB,L13,9AB,90,43,47,41
L13 9AD,L13,9AD,45,21,24,18
L13 9AE,L13,9AE,48,24,24,21
L13 9AF,L13,9AF,92,47,45,49
L13 9AG,L13,9AG,88,48,40,38
L13 9AH,L13,9AH,23,13,10,10
L13 9AJ,L13,9AJ,113,63,50,50
L13 9AL,L13,9AL,119,52,67,51
L13 9AN,L13,9AN,95,42,53,41
L13 9AP,L13,9AP,35,17,18,12
L13 9AQ,L13,9AQ,140,77,63,48
L13 9AR,L13,9AR,35,21,14,12
L13 9AS,L13,9AS,75,29,46,32
L13 9AT,L13,9AT,59,31,28,26
L13 9AU,L13,9AU,26,12,14,14
L13 9AW,L13,9AW,78,36,42,35
L13 9AX,L13,9AX,99,51,48,51
L13 9AY,L13,9AY,26,19,7,13
L13 9AZ,L13,9AZ,23,12,11,14
L13 9BA,L13,9BA,216,99,117,89
L13 9BB,L13,9BB,72,33,39,25
L13 9BD,L13,9BD,7,3,4,4
L13 9BE,L13,9BE,23,11,12,10
L13 9BG,L13,9BG,71,36,35,45
L13 9BH,L13,9BH,60,31,29,36
L13 9BJ,L13,9BJ,41,20,21,15
L13 9BL,L13,9BL,29,15,14,20
L13 9BN,L13,9BN,100,51,49,41
L13 9BP,L13,9BP,54,22,32,28
L13 9BQ,L13,9BQ,52,27,25,35
L13 9BR,L13,9BR,30,13,17,17
L13 9BS,L13,9BS,9,7,2,7
L13 9BT,L13,9BT,55,26,29,23
L13 9BU,L13,9BU,33,13,20,10
L13 9BX,L13,9BX,62,29,33,28
L13 9BY,L13,9BY,91,51,40,40
L13 9BZ,L13,9BZ,62,30,32,28
L13 9DA,L13,9DA,10,2,8,6
L13 9DB,L13,9DB,46,16,30,19
L13 9DD,L13,9DD,26,13,13,10
L13 9DE,L13,9DE,39,14,25,21
L13 9DF,L13,9DF,74,37,37,32
L13 9DG,L13,9DG,47,24,23,24
L13 9DH,L13,9DH,35,16,19,19
L13 9DJ,L13,9DJ,12,6,6,6
L13 9DL,L13,9DL,17,8,9,8
L13 9DN,L13,9DN,24,17,7,11
L13 9DP,L13,9DP,18,9,9,8
L13 9DR,L13,9DR,23,14,9,21
L14 0BA,L14,0BA,156,73,83,65
L14 0HZ,L14,0HZ,24,14,10,20
L14 0JA,L14,0JA,14,6,8,6
L14 0JB,L14,0JB,27,14,13,13
L14 0JD,L14,0JD,108,50,58,40
L14 0JE,L14,0JE,72,24,48,50
L14 0JF,L14,0JF,31,14,17,13
L14 0JG,L14,0JG,16,11,5,8
L14 0JH,L14,0JH,7,4,3,3
L14 0JJ,L14,0JJ,37,16,21,19
L14 0JL,L14,0JL,47,25,22,21
L14 0JN,L14,0JN,75,35,40,39
L14 0JP,L14,0JP,65,36,29,32
L14 0JQ,L14,0JQ,41,22,19,16
L14 0JR,L14,0JR,17,7,10,13
L14 0JS,L14,0JS,62,30,32,27
L14 0JT,L14,0JT,20,11,9,8
L14 0JU,L14,0JU,49,23,26,25
L14 0JW,L14,0JW,16,6,10,7
L14 0JX,L14,0JX,59,29,30,25
L14 0JY,L14,0JY,74,35,39,30
L14 0JZ,L14,0JZ,57,23,34,25
L14 0LA,L14,0LA,68,27,41,25
L14 0LB,L14,0LB,15,6,9,5
L14 0LD,L14,0LD,89,41,48,36
L14 0LE,L14,0LE,85,39,46,39
L14 0LF,L14,0LF,40,12,28,21
L14 0LG,L14,0LG,74,38,36,31
L14 0LH,L14,0LH,47,21,26,20
L14 0LJ,L14,0LJ,100,50,50,37
L14 0LL,L14,0LL,24,11,13,11
L14 0LN,L14,0LN,69,33,36,29
L14 0LP,L14,0LP,59,27,32,27
L14 0LQ,L14,0LQ,75,45,30,23
L14 0LR,L14,0LR,84,38,46,41
L14 0LS,L14,0LS,83,41,42,31
L14 0LU,L14,0LU,84,44,40,33
L14 0LW,L14,0LW,66,27,39,25
L14 0LX,L14,0LX,38,20,18,16
L14 0LY,L14,0LY,82,33,49,37
L14 0LZ,L14,0LZ,101,47,54,42
L14 0NA,L14,0NA,28,12,16,13
L14 0NB,L14,0NB,112,40,72,43
L14 0ND,L14,0ND,83,40,43,36
L14 0NE,L14,0NE,84,36,48,32
L14 0NF,L14,0NF,35,16,19,13
L14 0NG,L14,0NG,77,37,40,27
L14 0NH,L14,0NH,120,56,64,43
L14 0NJ,L14,0NJ,64,29,35,30
L14 0NL,L14,0NL,68,32,36,26
L14 0NN,L14,0NN,67,31,36,28
L14 0NP,L14,0NP,124,59,65,46
L14 0NQ,L14,0NQ,73,30,43,26
L14 0NR,L14,0NR,113,55,58,47
L14 0NS,L14,0NS,71,27,44,36
L14 0NT,L14,0NT,56,20,36,26
L14 0NU,L14,0NU,104,46,58,38
L14 0NW,L14,0NW,74,32,42,34
L14 0NX,L14,0NX,98,47,51,41
L14 0NY,L14,0NY,12,6,6,7
L14 0NZ,L14,0NZ,102,43,59,40
L14 0PD,L14,0PD,100,50,50,40
L14 0PE,L14,0PE,88,41,47,26
L14 0PF,L14,0PF,101,53,48,34
L14 0PG,L14,0PG,57,23,34,22
L14 0PH,L14,0PH,128,61,67,48
L14 0PJ,L14,0PJ,86,39,47,36
L14 0PL,L14,0PL,124,52,72,48
L14 0PN,L14,0PN,53,24,29,28
L14 0PQ,L14,0PQ,37,18,19,13
L14 1PA,L14,1PA,51,24,27,28
L14 1PB,L14,1PB,79,37,42,43
L14 1PD,L14,1PD,24,10,14,9
L14 1PE,L14,1PE,51,22,29,26
L14 1PF,L14,1PF,66,33,33,25
L14 1PG,L14,1PG,51,24,27,18
L14 1PH,L14,1PH,24,11,13,12
L14 1PJ,L14,1PJ,92,41,51,36
L14 1PL,L14,1PL,62,26,36,30
L14 1PN,L14,1PN,110,44,66,32
L14 1PP,L14,1PP,40,20,20,15
L14 1PQ,L14,1PQ,51,23,28,20
L14 1PR,L14,1PR,71,39,32,32
L14 1PS,L14,1PS,65,25,40,26
L14 1PT,L14,1PT,34,16,18,22
L14 1PU,L14,1PU,50,25,25,22
L14 1PW,L14,1PW,37,20,17,25
L14 1PX,L14,1PX,81,34,47,31
L14 1PY,L14,1PY,70,33,37,22
L14 1PZ,L14,1PZ,23,10,13,10
L14 1QA,L14,1QA,99,42,57,37
L14 1QB,L14,1QB,46,21,25,18
L14 1QD,L14,1QD,38,18,20,14
L14 1QE,L14,1QE,56,24,32,22
L14 1QF,L14,1QF,56,28,28,20
L14 1QG,L14,1QG,72,30,42,29
L14 1QH,L14,1QH,89,48,41,31
L14 1QJ,L14,1QJ,62,29,33,31
L14 1QL,L14,1QL,60,23,37,22
L14 1QN,L14,1QN,67,32,35,27
L14 1QQ,L14,1QQ,61,31,30,22
L14 2BA,L14,2BA,16,7,9,12
L14 2DA,L14,2DA,48,25,23,22
L14 2DB,L14,2DB,8,3,5,5
L14 2DD,L14,2DD,10,8,2,4
L14 2DE,L14,2DE,59,29,30,25
L14 2DF,L14,2DF,64,33,31,24
L14 2DG,L14,2DG,124,59,65,50
L14 2DH,L14,2DH,88,40,48,46
L14 2DJ,L14,2DJ,26,12,14,9
L14 2DL,L14,2DL,68,26,42,31
L14 2DN,L14,2DN,5,1,4,3
L14 2DP,L14,2DP,22,8,14,10
L14 2DQ,L14,2DQ,108,56,52,39
L14 2DR,L14,2DR,25,11,14,10
L14 2DS,L14,2DS,62,26,36,30
L14 2DT,L14,2DT,67,27,40,32
L14 2DU,L14,2DU,27,10,17,13
L14 2DW,L14,2DW,19,9,10,10
L14 2DX,L14,2DX,93,45,48,40
L14 2DY,L14,2DY,25,11,14,8
L14 2DZ,L14,2DZ,87,40,47,37
L14 2ED,L14,2ED,86,29,57,43
L14 2EE,L14,2EE,66,29,37,31
L14 2EF,L14,2EF,66,29,37,26
L14 2EG,L14,2EG,68,27,41,29
L14 2EH,L14,2EH,61,39,22,28
L14 2EJ,L14,2EJ,187,86,101,67
L14 2EL,L14,2EL,195,87,108,88
L14 2EN,L14,2EN,47,21,26,17
L14 2EP,L14,2EP,28,16,12,0
L14 2EQ,L14,2EQ,53,27,26,20
L14 2ER,L14,2ER,37,9,28,33
L14 2EW,L14,2EW,89,19,70,0
L14 2EY,L14,2EY,86,50,36,25
L14 2HA,L14,2HA,177,80,97,74
L14 2HB,L14,2HB,79,37,42,33
L14 3LA,L14,3LA,98,53,45,34
L14 3LB,L14,3LB,33,19,14,2
L14 3LD,L14,3LD,5,2,3,3
L14 3LE,L14,3LE,63,30,33,27
L14 3LF,L14,3LF,82,42,40,31
L14 3LG,L14,3LG,59,27,32,23
L14 3LH,L14,3LH,147,92,55,96
L14 3LJ,L14,3LJ,72,35,37,27
L14 3LL,L14,3LL,69,32,37,29
L14 3LN,L14,3LN,114,58,56,50
L14 3LP,L14,3LP,65,27,38,30
L14 3LQ,L14,3LQ,54,26,28,25
L14 3LR,L14,3LR,6,3,3,3
L14 3LS,L14,3LS,14,9,5,12
L14 3LT,L14,3LT,26,11,15,12
L14 3LU,L14,3LU,88,40,48,38
L14 3LW,L14,3LW,113,48,65,48
L14 3LX,L14,3LX,71,29,42,27
L14 3LY,L14,3LY,92,49,43,34
L14 3LZ,L14,3LZ,51,26,25,20
L14 3NA,L14,3NA,43,23,20,20
L14 3NB,L14,3NB,35,17,18,13
L14 3ND,L14,3ND,70,30,40,29
L14 3NN,L14,3NN,20,9,11,10
L14 3NP,L14,3NP,77,38,39,29
L14 3NQ,L14,3NQ,135,62,73,58
L14 3NR,L14,3NR,61,31,30,25
L14 3NU,L14,3NU,41,19,22,22
L14 3PA,L14,3PA,4,4,0,2
L14 3PE,L14,3PE,1,1,0,0
L14 3PJ,L14,3PJ,1,0,1,1
L14 4AD,L14,4AD,70,31,39,30
L14 4AE,L14,4AE,31,13,18,11
L14 4AF,L14,4AF,18,8,10,9
L14 4AG,L14,4AG,98,44,54,36
L14 4AH,L14,4AH,7,2,5,6
L14 4AN,L14,4AN,95,30,65,39
L14 4AP,L14,4AP,63,24,39,26
L14 4AQ,L14,4AQ,42,17,25,19
L14 4AR,L14,4AR,51,20,31,21
L14 4AS,L14,4AS,65,34,31,26
L14 4AT,L14,4AT,29,16,13,10
L14 4AU,L14,4AU,7,1,6,3
L14 4AW,L14,4AW,65,28,37,29
L14 4AX,L14,4AX,14,8,6,5
L14 4AY,L14,4AY,61,25,36,24
L14 4BB,L14,4BB,17,9,8,8
L14 4BD,L14,4BD,20,8,12,9
L14 4BE,L14,4BE,101,45,56,43
L14 4BG,L14,4BG,67,28,39,32
L14 4BH,L14,4BH,71,35,36,32
L14 4BJ,L14,4BJ,77,32,45,33
L14 4BL,L14,4BL,21,12,9,12
L14 4BN,L14,4BN,83,37,46,32
L14 4BP,L14,4BP,76,35,41,31
L14 4BQ,L14,4BQ,84,35,49,40
L14 4BR,L14,4BR,69,32,37,34
L14 4BW,L14,4BW,70,29,41,36
L14 4DG,L14,4DG,37,16,21,22
L14 4DL,L14,4DL,16,8,8,12
L14 4DQ,L14,4DQ,53,25,28,18
L14 4ED,L14,4ED,29,14,15,17
L14 4EE,L14,4EE,18,6,12,11
L14 5ND,L14,5ND,36,19,17,19
L14 5NG,L14,5NG,64,36,28,32
L14 5NJ,L14,5NJ,16,7,9,10
L14 5NL,L14,5NL,14,6,8,7
L14 5NN,L14,5NN,102,45,57,52
L14 5NP,L14,5NP,75,34,41,46
L14 5NR,L14,5NR,13,5,8,6
L14 5NT,L14,5NT,79,39,40,30
L14 5NU,L14,5NU,74,38,36,31
L14 5NW,L14,5NW,119,51,68,46
L14 5NX,L14,5NX,55,29,26,25
L14 5NY,L14,5NY,38,21,17,15
L14 5NZ,L14,5NZ,58,27,31,23
L14 5PA,L14,5PA,40,18,22,13
L14 5PB,L14,5PB,63,33,30,23
L14 5PD,L14,5PD,59,30,29,24
L14 5PE,L14,5PE,65,32,33,27
L14 5PF,L14,5PF,87,37,50,33
L14 5PG,L14,5PG,28,14,14,12
L14 5PH,L14,5PH,79,42,37,47
L14 5PJ,L14,5PJ,79,41,38,45
L14 5PL,L14,5PL,92,58,34,59
L14 5PP,L14,5PP,20,14,6,19
L14 5PQ,L14,5PQ,68,38,30,38
L14 5PR,L14,5PR,12,4,8,5
L14 5PS,L14,5PS,9,1,8,9
L14 6TA,L14,6TA,97,50,47,36
L14 6TB,L14,6TB,33,17,16,15
L14 6TD,L14,6TD,114,56,58,45
L14 6TE,L14,6TE,88,42,46,35
L14 6TF,L14,6TF,153,78,75,51
L14 6TG,L14,6TG,70,33,37,30
L14 6TH,L14,6TH,74,40,34,32
L14 6TJ,L14,6TJ,69,30,39,26
L14 6TL,L14,6TL,43,20,23,18
L14 6TN,L14,6TN,42,22,20,20
L14 6TP,L14,6TP,79,39,40,34
L14 6TQ,L14,6TQ,112,55,57,46
L14 6TR,L14,6TR,90,45,45,33
L14 6TS,L14,6TS,75,32,43,25
L14 6TT,L14,6TT,17,9,8,13
L14 6TU,L14,6TU,72,36,36,28
L14 6TW,L14,6TW,26,9,17,12
L14 6TX,L14,6TX,33,18,15,18
L14 6TY,L14,6TY,36,15,21,13
L14 6UA,L14,6UA,95,50,45,41
L14 6UB,L14,6UB,86,45,41,36
L14 6UD,L14,6UD,67,32,35,28
L14 6UE,L14,6UE,25,14,11,11
L14 6UF,L14,6UF,72,37,35,33
L14 6UG,L14,6UG,85,38,47,30
L14 6UH,L14,6UH,34,13,21,17
L14 6UJ,L14,6UJ,49,26,23,18
L14 6UL,L14,6UL,60,31,29,25
L14 6UN,L14,6UN,82,40,42,35
L14 6UP,L14,6UP,99,46,53,35
L14 6UQ,L14,6UQ,24,9,15,11
L14 6UR,L14,6UR,69,33,36,26
L14 6US,L14,6US,58,24,34,27
L14 6UT,L14,6UT,86,43,43,28
L14 6UU,L14,6UU,63,30,33,24
L14 6UW,L14,6UW,42,16,26,19
L14 6UX,L14,6UX,48,22,26,15
L14 6UY,L14,6UY,58,25,33,31
L14 6UZ,L14,6UZ,86,36,50,39
L14 6XA,L14,6XA,65,30,35,21
L14 6XB,L14,6XB,48,28,20,17
L14 7GA,L14,7GA,13,7,6,6
L14 7LN,L14,7LN,44,16,28,38
L14 7NA,L14,7NA,70,30,40,26
L14 7NB,L14,7NB,29,7,22,0
L14 7ND,L14,7ND,51,20,31,20
L14 7NG,L14,7NG,29,15,14,26
L14 7NH,L14,7NH,42,17,25,15
L14 7NJ,L14,7NJ,88,40,48,35
L14 7NL,L14,7NL,84,40,44,33
L14 7NN,L14,7NN,73,36,37,28
L14 7NP,L14,7NP,35,16,19,15
L14 7NQ,L14,7NQ,36,18,18,32
L14 7NR,L14,7NR,57,24,33,23
L14 7NS,L14,7NS,41,18,23,18
L14 7NT,L14,7NT,56,25,31,26
L14 7NU,L14,7NU,76,34,42,27
L14 7NW,L14,7NW,97,45,52,40
L14 7NX,L14,7NX,54,27,27,19
L14 7NY,L14,7NY,24,16,8,9
L14 7NZ,L14,7NZ,41,19,22,2
L14 7PA,L14,7PA,43,23,20,19
L14 7PB,L14,7PB,50,24,26,19
L14 7PD,L14,7PD,42,20,22,16
L14 7PE,L14,7PE,69,33,36,32
L14 7PF,L14,7PF,73,32,41,31
L14 7PG,L14,7PG,64,25,39,24
L14 7PH,L14,7PH,43,25,18,25
L14 7PJ,L14,7PJ,22,12,10,6
L14 7PL,L14,7PL,58,25,33,22
L14 7PN,L14,7PN,51,28,23,20
L14 7PP,L14,7PP,79,32,47,33
L14 7PQ,L14,7PQ,86,39,47,33
L14 7PR,L14,7PR,67,35,32,32
L14 7PS,L14,7PS,66,24,42,31
L14 7PT,L14,7PT,59,27,32,24
L14 7PU,L14,7PU,88,44,44,30
L14 7PW,L14,7PW,72,33,39,28
L14 7PX,L14,7PX,47,20,27,21
L14 7PY,L14,7PY,70,34,36,33
L14 7PZ,L14,7PZ,67,33,34,31
L14 7QA,L14,7QA,27,15,12,20
L14 7QB,L14,7QB,98,51,47,35
L14 7QD,L14,7QD,42,17,25,18
L14 7QE,L14,7QE,100,51,49,35
L14 7QF,L14,7QF,86,40,46,36
L14 7QG,L14,7QG,77,32,45,29
L14 7QJ,L14,7QJ,36,19,17,14
L14 7QL,L14,7QL,92,38,54,39
L14 7QQ,L14,7QQ,77,35,42,29
L14 7QS,L14,7QS,6,4,2,5
L14 7QW,L14,7QW,44,24,20,18
L14 8UA,L14,8UA,83,39,44,31
L14 8UB,L14,8UB,97,42,55,37
L14 8UD,L14,8UD,22,14,8,9
L14 8UE,L14,8UE,111,44,67,49
L14 8UH,L14,8UH,85,39,46,38
L14 8UL,L14,8UL,4,4,0,1
L14 8UR,L14,8UR,35,14,21,14
L14 8UW,L14,8UW,58,26,32,28
L14 8UX,L14,8UX,94,38,56,36
L14 8UY,L14,8UY,80,37,43,38
L14 8UZ,L14,8UZ,49,24,25,19
L14 8WY,L14,8WY,74,40,34,23
L14 8XA,L14,8XA,38,16,22,18
L14 8XB,L14,8XB,54,24,30,24
L14 8XD,L14,8XD,59,29,30,24
L14 8XE,L14,8XE,95,47,48,41
L14 8XG,L14,8XG,13,5,8,5
L14 8XH,L14,8XH,75,33,42,35
L14 8XJ,L14,8XJ,38,14,24,16
L14 8XL,L14,8XL,59,29,30,26
L14 8XN,L14,8XN,127,61,66,51
L14 8XP,L14,8XP,171,72,99,67
L14 8XQ,L14,8XQ,44,17,27,24
L14 8XR,L14,8XR,104,57,47,42
L14 8XS,L14,8XS,47,19,28,17
L14 8XU,L14,8XU,116,45,71,37
L14 8XW,L14,8XW,51,16,35,20
L14 8XX,L14,8XX,102,44,58,44
L14 8XY,L14,8XY,55,21,34,23
L14 8XZ,L14,8XZ,24,9,15,13
L14 8YA,L14,8YA,20,9,11,12
L14 8YB,L14,8YB,57,21,36,27
L14 8YD,L14,8YD,76,40,36,32
L14 8YE,L14,8YE,50,22,28,25
L14 8YF,L14,8YF,46,21,25,23
L14 8YG,L14,8YG,37,20,17,15
L14 8YJ,L14,8YJ,11,8,3,8
L14 8YL,L14,8YL,52,28,24,47
L14 8YN,L14,8YN,12,5,7,6
L14 8YQ,L14,8YQ,18,7,11,13
L14 9LL,L14,9LL,34,13,21,13
L14 9LN,L14,9LN,80,42,38,28
L14 9LP,L14,9LP,108,51,57,38
L14 9LR,L14,9LR,146,73,73,55
L14 9LS,L14,9LS,147,73,74,59
L14 9LT,L14,9LT,199,88,111,58
L14 9LU,L14,9LU,45,19,26,17
L14 9LW,L14,9LW,62,28,34,23
L14 9LX,L14,9LX,95,49,46,38
L14 9LY,L14,9LY,64,33,31,27
L14 9LZ,L14,9LZ,50,25,25,19
L14 9NA,L14,9NA,62,34,28,32
L14 9NB,L14,9NB,2,1,1,1
L14 9NF,L14,9NF,104,44,60,42
L14 9NG,L14,9NG,79,33,46,31
L14 9NH,L14,9NH,102,42,60,41
L14 9NL,L14,9NL,86,35,51,42
L14 9NN,L14,9NN,80,34,46,28
L14 9NP,L14,9NP,104,43,61,48
L14 9NQ,L14,9NQ,93,45,48,39
L14 9NR,L14,9NR,81,35,46,39
L14 9NS,L14,9NS,85,41,44,37
L14 9NW,L14,9NW,56,23,33,26
L14 9NX,L14,9NX,62,28,34,42
L14 9NY,L14,9NY,57,24,33,28
L14 9NZ,L14,9NZ,57,27,30,27
L14 9PA,L14,9PA,83,41,42,30
L14 9PB,L14,9PB,69,34,35,36
L14 9PE,L14,9PE,54,32,22,27
L14 9PF,L14,9PF,53,27,26,27
L14 9PG,L14,9PG,59,25,34,22
L14 9PH,L14,9PH,25,17,8,20
L14 9PJ,L14,9PJ,31,13,18,18
L14 9PP,L14,9PP,94,34,60,33
L14 9PQ,L14,9PQ,26,11,15,12
L14 9PR,L14,9PR,61,26,35,21
L14 9PS,L14,9PS,67,32,35,29
L14 9PT,L14,9PT,80,35,45,30
L14 9PU,L14,9PU,39,23,16,12
L14 9PW,L14,9PW,104,47,57,45
L14 9PX,L14,9PX,92,41,51,41
L14 9PY,L14,9PY,81,40,41,42
L14 9PZ,L14,9PZ,54,27,27,26
L14 9QA,L14,9QA,58,30,28,33
L14 9QB,L14,9QB,100,51,49,43
L14 9QD,L14,9QD,46,19,27,21
L14 9QE,L14,9QE,7,4,3,3
L14 9QN,L14,9QN,221,98,123,69
L14 9QT,L14,9QT,98,44,54,36
L14 9QU,L14,9QU,85,39,46,29
L14 9QX,L14,9QX,37,18,19,17
L14 9QY,L14,9QY,36,15,21,15
L14 9QZ,L14,9QZ,27,14,13,14
L15 0AB,L15,0AB,149,69,80,77
L15 0AD,L15,0AD,29,19,10,14
L15 0DW,L15,0DW,11,10,1,2
L15 0EB,L15,0EB,50,37,13,17
L15 0ED,L15,0ED,59,31,28,38
L15 0EE,L15,0EE,23,11,12,7
L15 0EF,L15,0EF,122,65,57,51
L15 0EG,L15,0EG,61,44,17,22
L15 0EH,L15,0EH,145,69,76,53
L15 0EJ,L15,0EJ,75,42,33,23
L15 0EL,L15,0EL,38,26,12,15
L15 0EN,L15,0EN,89,41,48,32
L15 0EP,L15,0EP,53,23,30,24
L15 0EQ,L15,0EQ,122,62,60,43
L15 0ER,L15,0ER,36,20,16,15
L15 0ES,L15,0ES,33,16,17,16
L15 0ET,L15,0ET,73,33,40,26
L15 0EW,L15,0EW,160,77,83,55
L15 0EY,L15,0EY,68,36,32,33
L15 0EZ,L15,0EZ,99,48,51,41
L15 0HA,L15,0HA,67,25,42,30
L15 0HB,L15,0HB,80,39,41,48
L15 0HD,L15,0HD,29,14,15,15
L15 0HE,L15,0HE,74,33,41,40
L15 0HF,L15,0HF,81,38,43,39
L15 0HG,L15,0HG,66,33,33,41
L15 0HH,L15,0HH,133,64,69,46
L15 0HJ,L15,0HJ,57,20,37,24
L15 0HL,L15,0HL,34,17,17,14
L15 0HN,L15,0HN,87,42,45,46
L15 0HP,L15,0HP,51,22,29,22
L15 0HQ,L15,0HQ,80,36,44,41
L15 0HR,L15,0HR,115,61,54,41
L15 0HS,L15,0HS,107,48,59,44
L15 0HT,L15,0HT,142,79,63,65
L15 0HU,L15,0HU,95,49,46,53
L15 0HW,L15,0HW,83,36,47,43
L15 0HX,L15,0HX,14,10,4,11
L15 0HY,L15,0HY,42,20,22,17
L15 0JA,L15,0JA,38,25,13,25
L15 0JB,L15,0JB,10,10,0,0
L15 1EA,L15,1EA,69,28,41,36
L15 1EB,L15,1EB,69,33,36,34
L15 1ED,L15,1ED,61,36,25,36
L15 1EE,L15,1EE,66,28,38,38
L15 1EF,L15,1EF,77,34,43,46
L15 1EG,L15,1EG,95,48,47,58
L15 1EH,L15,1EH,35,18,17,19
L15 1EJ,L15,1EJ,97,41,56,58
L15 1EL,L15,1EL,129,68,61,65
L15 1EN,L15,1EN,112,57,55,52
L15 1EP,L15,1EP,29,18,11,13
L15 1EQ,L15,1EQ,69,31,38,39
L15 1ER,L15,1ER,18,8,10,10
L15 1ES,L15,1ES,119,57,62,53
L15 1ET,L15,1ET,81,35,46,33
L15 1EU,L15,1EU,27,17,10,16
L15 1EW,L15,1EW,90,43,47,49
L15 1EX,L15,1EX,40,20,20,20
L15 1EY,L15,1EY,68,36,32,35
L15 1EZ,L15,1EZ,134,73,61,54
L15 1HA,L15,1HA,35,13,22,13
L15 1HB,L15,1HB,30,20,10,11
L15 1HD,L15,1HD,25,8,17,14
L15 1HE,L15,1HE,55,25,30,22
L15 1HF,L15,1HF,76,36,40,35
L15 1HG,L15,1HG,124,67,57,46
L15 1HH,L15,1HH,114,51,63,40
L15 1HJ,L15,1HJ,30,17,13,18
L15 1HL,L15,1HL,42,18,24,23
L15 1HN,L15,1HN,122,62,60,50
L15 1HP,L15,1HP,78,33,45,35
L15 1HQ,L15,1HQ,162,66,96,61
L15 1HR,L15,1HR,100,50,50,35
L15 1HS,L15,1HS,47,25,22,36
L15 1HT,L15,1HT,11,4,7,8
L15 1HU,L15,1HU,56,28,28,27
L15 1HW,L15,1HW,169,85,84,71
L15 1HX,L15,1HX,42,21,21,21
L15 2HA,L15,2HA,173,85,88,70
L15 2HD,L15,2HD,85,50,35,29
L15 2HF,L15,2HF,62,36,26,36
L15 2HG,L15,2HG,108,58,50,40
L15 2HH,L15,2HH,109,56,53,39
L15 2HJ,L15,2HJ,118,60,58,44
L15 2HL,L15,2HL,208,106,102,66
L15 2HN,L15,2HN,118,48,70,38
L15 2HP,L15,2HP,121,79,42,41
L15 2HQ,L15,2HQ,150,88,62,52
L15 2HR,L15,2HR,95,52,43,36
L15 2HS,L15,2HS,125,65,60,47
L15 2HT,L15,2HT,123,64,59,44
L15 2HU,L15,2HU,181,98,83,49
L15 2HW,L15,2HW,135,68,67,36
L15 2HX,L15,2HX,189,108,81,66
L15 2HY,L15,2HY,94,48,46,38
L15 2HZ,L15,2HZ,87,39,48,39
L15 2JA,L15,2JA,17,10,7,9
L15 2JB,L15,2JB,23,14,9,8
L15 2JD,L15,2JD,51,35,16,19
L15 2JE,L15,2JE,99,51,48,33
L15 2JZ,L15,2JZ,65,27,38,31
L15 2LA,L15,2LA,15,9,6,10
L15 3AH,L15,3AH,41,25,16,23
L15 3HA,L15,3HA,43,23,20,24
L15 3HE,L15,3HE,143,69,74,55
L15 3HF,L15,3HF,176,90,86,65
L15 3HG,L15,3HG,162,94,68,44
L15 3HH,L15,3HH,175,70,105,51
L15 3HJ,L15,3HJ,92,35,57,31
L15 3HL,L15,3HL,101,41,60,33
L15 3HN,L15,3HN,88,45,43,19
L15 3HP,L15,3HP,213,108,105,61
L15 3HQ,L15,3HQ,207,98,109,66
L15 3HR,L15,3HR,162,90,72,59
L15 3HS,L15,3HS,189,105,84,59
L15 3HT,L15,3HT,171,74,97,61
L15 3HU,L15,3HU,138,75,63,48
L15 3HW,L15,3HW,88,45,43,24
L15 3HX,L15,3HX,140,68,72,53
L15 3HZ,L15,3HZ,47,20,27,28
L15 3JA,L15,3JA,15,10,5,5
L15 3JD,L15,3JD,55,27,28,29
L15 3JE,L15,3JE,212,96,116,65
L15 3JF,L15,3JF,158,72,86,60
L15 3JG,L15,3JG,159,81,78,37
L15 3JH,L15,3JH,375,204,171,88
L15 3JJ,L15,3JJ,123,54,69,35
L15 3JL,L15,3JL,91,34,57,21
L15 3JN,L15,3JN,59,24,35,26
L15 3JQ,L15,3JQ,171,112,59,49
L15 3JR,L15,3JR,36,17,19,12
L15 3JT,L15,3JT,52,27,25,14
L15 3JY,L15,3JY,119,57,62,34
L15 3JZ,L15,3JZ,108,50,58,34
L15 3LA,L15,3LA,333,175,158,83
L15 3LB,L15,3LB,97,47,50,21
L15 3LD,L15,3LD,99,46,53,20
L15 3LE,L15,3LE,99,53,46,23
L15 3LL,L15,3LL,22,11,11,19
L15 4HA,L15,4HA,123,59,64,56
L15 4HB,L15,4HB,136,70,66,60
L15 4HD,L15,4HD,49,29,20,17
L15 4HE,L15,4HE,60,28,32,28
L15 4HF,L15,4HF,60,32,28,29
L15 4HG,L15,4HG,149,88,61,68
L15 4HH,L15,4HH,53,26,27,32
L15 4HJ,L15,4HJ,80,43,37,52
L15 4HL,L15,4HL,78,42,36,43
L15 4HN,L15,4HN,75,41,34,34
L15 4HP,L15,4HP,89,44,45,47
L15 4HQ,L15,4HQ,96,45,51,51
L15 4HR,L15,4HR,77,37,40,34
L15 4HS,L15,4HS,78,39,39,38
L15 4HT,L15,4HT,95,44,51,38
L15 4HU,L15,4HU,96,51,45,48
L15 4HW,L15,4HW,120,60,60,45
L15 4HX,L15,4HX,86,46,40,36
L15 4HY,L15,4HY,47,26,21,30
L15 4HZ,L15,4HZ,66,31,35,31
L15 4JA,L15,4JA,104,54,50,50
L15 4JD,L15,4JD,101,62,39,45
L15 4JE,L15,4JE,77,39,38,31
L15 4JF,L15,4JF,80,44,36,37
L15 4JG,L15,4JG,14,6,8,6
L15 4JL,L15,4JL,39,17,22,21
L15 4JN,L15,4JN,89,55,34,41
L15 4JP,L15,4JP,18,9,9,10
L15 4JQ,L15,4JQ,53,27,26,33
L15 4JS,L15,4JS,9,4,5,4
L15 4JT,L15,4JT,59,31,28,32
L15 4JU,L15,4JU,66,28,38,40
L15 4JX,L15,4JX,101,42,59,62
L15 4LA,L15,4LA,74,37,37,43
L15 4LB,L15,4LB,43,23,20,28
L15 4LF,L15,4LF,64,35,29,24
L15 4LG,L15,4LG,15,9,6,12
L15 4LH,L15,4LH,61,43,18,28
L15 4LJ,L15,4LJ,7,5,2,5
L15 4LL,L15,4LL,22,13,9,13
L15 4LP,L15,4LP,12,10,2,5
L15 4LR,L15,4LR,95,40,55,46
L15 4LS,L15,4LS,90,42,48,44
L15 4LT,L15,4LT,18,8,10,12
L15 4LU,L15,4LU,44,16,28,23
L15 4LX,L15,4LX,36,16,20,21
L15 4LY,L15,4LY,53,26,27,35
L15 4NA,L15,4NA,28,15,13,14
L15 4NB,L15,4NB,68,36,32,32
L15 4ND,L15,4ND,140,77,63,59
L15 4NE,L15,4NE,67,38,29,39
L15 4NF,L15,4NF,62,26,36,36
L15 4NG,L15,4NG,40,22,18,18
L15 4NN,L15,4NN,13,6,7,7
L15 4PE,L15,4PE,69,31,38,26
L15 4PF,L15,4PF,43,20,23,16
L15 4PG,L15,4PG,5,3,2,4
L15 4PP,L15,4PP,46,20,26,15
L15 4PW,L15,4PW,161,85,76,54
L15 5AD,L15,5AD,171,102,69,51
L15 5AE,L15,5AE,52,35,17,14
L15 5AF,L15,5AF,18,14,4,4
L15 5AG,L15,5AG,13,8,5,7
L15 5AH,L15,5AH,71,39,32,18
L15 5AJ,L15,5AJ,79,46,33,24
L15 5AL,L15,5AL,26,12,14,14
L15 5AN,L15,5AN,16,10,6,5
L15 5AR,L15,5AR,29,15,14,10
L15 5AT,L15,5AT,86,48,38,37
L15 5AU,L15,5AU,59,19,40,22
L15 5AX,L15,5AX,39,23,16,18
L15 5AY,L15,5AY,101,48,53,35
L15 5AZ,L15,5AZ,66,33,33,25
L15 5BA,L15,5BA,11,6,5,8
L15 5BB,L15,5BB,17,9,8,9
L15 5BD,L15,5BD,72,31,41,34
L15 5BE,L15,5BE,28,13,15,11
L15 5BG,L15,5BG,49,25,24,22
L15 5BH,L15,5BH,39,23,16,18
L15 5BJ,L15,5BJ,54,28,26,26
L15 5BL,L15,5BL,58,28,30,29
L15 5BN,L15,5BN,100,57,43,48
L15 5BP,L15,5BP,89,50,39,34
L15 5BR,L15,5BR,61,31,30,27
L15 5BS,L15,5BS,73,41,32,31
L15 5BT,L15,5BT,97,45,52,34
L15 5BU,L15,5BU,79,38,41,34
L15 5BW,L15,5BW,80,37,43,32
L15 5BX,L15,5BX,69,32,37,31
L15 5BY,L15,5BY,19,13,6,13
L15 5BZ,L15,5BZ,145,73,72,55
L15 6DA,L15,6DA,3,2,1,2
L15 6DL,L15,6DL,7,5,2,5
L15 6SA,L15,6SA,3,1,2,1
L15 6TA,L15,6TA,72,34,38,29
L15 6TB,L15,6TB,20,9,11,10
L15 6TD,L15,6TD,34,16,18,16
L15 6TE,L15,6TE,21,12,9,10
L15 6TF,L15,6TF,49,24,25,21
L15 6TG,L15,6TG,48,23,25,23
L15 6TH,L15,6TH,54,28,26,20
L15 6TJ,L15,6TJ,50,22,28,25
L15 6TL,L15,6TL,43,20,23,16
L15 6TN,L15,6TN,7,3,4,4
L15 6TP,L15,6TP,4,2,2,2
L15 6TR,L15,6TR,48,22,26,21
L15 6TS,L15,6TS,23,8,15,15
L15 6TT,L15,6TT,44,21,23,16
L15 6TU,L15,6TU,28,14,14,13
L15 6TW,L15,6TW,6,0,6,0
L15 6TX,L15,6TX,21,8,13,10
L15 6TY,L15,6TY,52,29,23,22
L15 6TZ,L15,6TZ,32,13,19,14
L15 6UA,L15,6UA,43,23,20,16
L15 6UB,L15,6UB,90,45,45,35
L15 6UD,L15,6UD,77,37,40,28
L15 6UE,L15,6UE,74,37,37,27
L15 6UF,L15,6UF,58,24,34,26
L15 6UG,L15,6UG,76,34,42,28
L15 6UH,L15,6UH,53,22,31,20
L15 6UJ,L15,6UJ,116,50,66,44
L15 6UL,L15,6UL,38,20,18,15
L15 6UN,L15,6UN,61,30,31,23
L15 6UQ,L15,6UQ,57,30,27,22
L15 6UR,L15,6UR,52,24,28,20
L15 6US,L15,6US,55,29,26,22
L15 6UT,L15,6UT,50,24,26,20
L15 6UU,L15,6UU,34,19,15,14
L15 6UW,L15,6UW,42,23,19,18
L15 6UX,L15,6UX,89,47,42,34
L15 6UY,L15,6UY,45,21,24,16
L15 6WA,L15,6WA,109,54,55,47
L15 6WB,L15,6WB,33,18,15,8
L15 6XA,L15,6XA,37,19,18,16
L15 6XB,L15,6XB,53,21,32,22
L15 6XD,L15,6XD,30,17,13,13
L15 6XE,L15,6XE,31,16,15,13
L15 6XF,L15,6XF,60,31,29,23
L15 6XG,L15,6XG,43,24,19,13
L15 6XJ,L15,6XJ,44,19,25,18
L15 6XL,L15,6XL,4,3,1,1
L15 6XN,L15,6XN,63,31,32,24
L15 6XP,L15,6XP,48,15,33,19
L15 6XQ,L15,6XQ,65,36,29,25
L15 6XR,L15,6XR,59,33,26,21
L15 6XS,L15,6XS,5,3,2,1
L15 6XT,L15,6XT,60,27,33,24
L15 6XU,L15,6XU,50,28,22,16
L15 6XW,L15,6XW,39,19,20,13
L15 6XX,L15,6XX,66,34,32,22
L15 6YA,L15,6YA,12,4,8,8
L15 6YB,L15,6YB,12,9,3,5
L15 6YE,L15,6YE,47,24,23,14
L15 6YF,L15,6YF,46,24,22,15
L15 6YQ,L15,6YQ,4,3,1,2
L15 7JA,L15,7JA,92,45,47,33
L15 7JB,L15,7JB,108,52,56,55
L15 7JD,L15,7JD,94,42,52,44
L15 7JE,L15,7JE,101,49,52,42
L15 7JF,L15,7JF,110,51,59,42
L15 7JG,L15,7JG,53,29,24,23
L15 7JH,L15,7JH,44,20,24,16
L15 7JJ,L15,7JJ,73,35,38,33
L15 7JL,L15,7JL,119,59,60,49
L15 7JN,L15,7JN,127,50,77,59
L15 7JP,L15,7JP,81,38,43,39
L15 7JQ,L15,7JQ,50,21,29,23
L15 7JR,L15,7JR,24,11,13,12
L15 7JS,L15,7JS,88,42,46,33
L15 7JT,L15,7JT,48,20,28,21
L15 7JU,L15,7JU,28,13,15,12
L15 7JW,L15,7JW,89,39,50,43
L15 7JX,L15,7JX,76,38,38,27
L15 7JY,L15,7JY,32,18,14,12
L15 7JZ,L15,7JZ,68,31,37,29
L15 7LA,L15,7LA,53,26,27,22
L15 7LB,L15,7LB,56,32,24,22
L15 7LD,L15,7LD,32,14,18,14
L15 7LE,L15,7LE,48,20,28,20
L15 7LF,L15,7LF,30,13,17,17
L15 7LG,L15,7LG,49,26,23,20
L15 7LH,L15,7LH,58,30,28,25
L15 7LJ,L15,7LJ,79,30,49,33
L15 7LL,L15,7LL,30,13,17,11
L15 7LN,L15,7LN,57,25,32,22
L15 7LP,L15,7LP,82,41,41,32
L15 7LQ,L15,7LQ,68,33,35,28
L15 7LR,L15,7LR,42,17,25,21
L15 7LS,L15,7LS,92,45,47,33
L15 7LT,L15,7LT,13,5,8,10
L15 7LU,L15,7LU,134,64,70,55
L15 7LW,L15,7LW,52,24,28,22
L15 7LX,L15,7LX,76,40,36,33
L15 7LY,L15,7LY,72,37,35,29
L15 7LZ,L15,7LZ,67,26,41,30
L15 7NA,L15,7NA,8,3,5,3
L15 7NB,L15,7NB,24,12,12,9
L15 7ND,L15,7ND,46,23,23,16
L15 7NE,L15,7NE,38,18,20,26
L15 7NF,L15,7NF,30,16,14,10
L15 7NG,L15,7NG,42,18,24,16
L15 7NS,L15,7NS,27,13,14,22
L15 8AD,L15,8AD,59,35,24,30
L15 8AE,L15,8AE,110,45,65,56
L15 8AF,L15,8AF,36,17,19,18
L15 8AH,L15,8AH,14,6,8,10
L15 8AJ,L15,8AJ,98,48,50,40
L15 8AL,L15,8AL,124,67,57,48
L15 8AN,L15,8AN,107,49,58,45
L15 8AR,L15,8AR,9,6,3,5
L15 8AX,L15,8AX,98,47,51,51
L15 8GA,L15,8GA,97,44,53,35
L15 8GB,L15,8GB,74,34,40,22
L15 8GD,L15,8GD,88,34,54,53
L15 8GE,L15,8GE,22,7,15,6
L15 8GG,L15,8GG,45,13,32,38
L15 8GH,L15,8GH,20,15,5,16
L15 8GJ,L15,8GJ,29,16,13,27
L15 8GL,L15,8GL,21,14,7,12
L15 8HA,L15,8HA,85,43,42,71
L15 8HB,L15,8HB,108,55,53,65
L15 8HE,L15,8HE,35,19,16,13
L15 8HF,L15,8HF,12,9,3,5
L15 8HG,L15,8HG,54,36,18,26
L15 8HH,L15,8HH,138,53,85,45
L15 8HJ,L15,8HJ,6,3,3,4
L15 8HL,L15,8HL,70,45,25,37
L15 8HN,L15,8HN,2,1,1,1
L15 8HP,L15,8HP,31,11,20,17
L15 8HR,L15,8HR,23,13,10,13
L15 8HS,L15,8HS,116,59,57,51
L15 8HT,L15,8HT,16,9,7,8
L15 8HU,L15,8HU,25,11,14,10
L15 8HW,L15,8HW,29,14,15,14
L15 8HX,L15,8HX,64,27,37,29
L15 8HY,L15,8HY,117,57,60,40
L15 8JA,L15,8JA,15,9,6,4
L15 8JB,L15,8JB,10,5,5,5
L15 8JD,L15,8JD,22,12,10,9
L15 8JE,L15,8JE,78,39,39,37
L15 8JF,L15,8JF,33,15,18,12
L15 8JG,L15,8JG,78,46,32,50
L15 8JH,L15,8JH,31,15,16,15
L15 8JJ,L15,8JJ,89,58,31,54
L15 8JL,L15,8JL,80,44,36,44
L15 8JN,L15,8JN,68,29,39,22
L15 8JP,L15,8JP,22,12,10,11
L15 8JQ,L15,8JQ,33,17,16,12
L15 8JR,L15,8JR,33,15,18,18
L15 8JS,L15,8JS,25,14,11,13
L15 8JT,L15,8JT,41,23,18,27
L15 8JU,L15,8JU,25,15,10,11
L15 8JW,L15,8JW,15,8,7,10
L15 8JX,L15,8JX,52,27,25,31
L15 8JY,L15,8JY,17,8,9,8
L15 8JZ,L15,8JZ,34,16,18,20
L15 8LE,L15,8LE,100,40,60,45
L15 8LF,L15,8LF,11,6,5,4
L15 8LG,L15,8LG,73,28,45,31
L15 8LH,L15,8LH,11,3,8,5
L15 8LJ,L15,8LJ,75,39,36,22
L15 8LL,L15,8LL,58,31,27,20
L15 8LN,L15,8LN,26,9,17,1
L15 8LP,L15,8LP,16,6,10,9
L15 8LQ,L15,8LQ,74,39,35,44
L15 8LR,L15,8LR,48,24,24,20
L15 8LS,L15,8LS,69,39,30,32
L15 8LT,L15,8LT,64,36,28,25
L15 8LU,L15,8LU,139,70,69,54
L15 8LX,L15,8LX,28,17,11,10
L15 8LY,L15,8LY,36,19,17,32
L15 8LZ,L15,8LZ,106,54,52,39
L15 8NA,L15,8NA,35,18,17,13
L15 8NB,L15,8NB,43,21,22,19
L15 9EA,L15,9EA,11,9,2,4
L15 9ED,L15,9ED,8,6,2,5
L15 9EF,L15,9EF,53,27,26,23
L15 9EH,L15,9EH,7,4,3,4
L15 9EJ,L15,9EJ,66,37,29,41
L15 9EQ,L15,9EQ,38,20,18,13
L15 9ER,L15,9ER,60,28,32,30
L15 9ES,L15,9ES,58,29,29,22
L15 9ET,L15,9ET,61,29,32,26
L15 9EU,L15,9EU,69,32,37,27
L15 9EY,L15,9EY,53,28,25,22
L15 9EZ,L15,9EZ,77,46,31,31
L15 9HA,L15,9HA,60,28,32,24
L15 9HB,L15,9HB,52,22,30,23
L15 9HD,L15,9HD,74,33,41,36
L15 9HE,L15,9HE,77,38,39,46
L15 9HF,L15,9HF,84,36,48,33
L15 9HG,L15,9HG,75,43,32,29
L15 9HH,L15,9HH,51,23,28,19
L15 9HJ,L15,9HJ,70,38,32,29
L15 9HL,L15,9HL,89,43,46,25
L15 9HN,L15,9HN,71,33,38,27
L15 9HP,L15,9HP,83,40,43,41
L15 9HQ,L15,9HQ,60,32,28,30
L15 9HR,L15,9HR,63,41,22,26
L15 9HW,L15,9HW,92,47,45,42
L16 0JA,L16,0JA,18,10,8,8
L16 0JE,L16,0JE,89,45,44,34
L16 0JF,L16,0JF,87,45,42,29
L16 0JG,L16,0JG,55,26,29,19
L16 0JH,L16,0JH,35,21,14,14
L16 0JJ,L16,0JJ,68,35,33,29
L16 0JL,L16,0JL,87,42,45,31
L16 0JN,L16,0JN,26,13,13,14
L16 0JQ,L16,0JQ,86,43,43,28
L16 0JR,L16,0JR,77,38,39,30
L16 0JS,L16,0JS,18,8,10,7
L16 0JT,L16,0JT,153,79,74,56
L16 0JW,L16,0JW,5,2,3,3
L16 1HZ,L16,1HZ,3,1,2,1
L16 1JA,L16,1JA,61,33,28,22
L16 1JB,L16,1JB,63,27,36,26
L16 1JD,L16,1JD,69,34,35,28
L16 1JE,L16,1JE,89,46,43,39
L16 1JF,L16,1JF,55,22,33,24
L16 1JG,L16,1JG,92,46,46,43
L16 1JH,L16,1JH,16,7,9,8
L16 1JJ,L16,1JJ,8,4,4,7
L16 1JL,L16,1JL,41,22,19,15
L16 1JN,L16,1JN,57,29,28,23
L16 1JP,L16,1JP,69,27,42,30
L16 1JQ,L16,1JQ,94,40,54,41
L16 1JR,L16,1JR,87,43,44,37
L16 1JS,L16,1JS,85,39,46,31
L16 1JT,L16,1JT,49,24,25,18
L16 1JU,L16,1JU,14,8,6,8
L16 1JW,L16,1JW,76,32,44,32
L16 1JX,L16,1JX,18,8,10,8
L16 1JY,L16,1JY,11,5,6,4
L16 1JZ,L16,1JZ,66,31,35,30
L16 1LA,L16,1LA,84,39,45,31
L16 1LD,L16,1LD,81,41,40,31
L16 2LA,L16,2LA,73,38,35,28
L16 2LB,L16,2LB,121,56,65,44
L16 2LD,L16,2LD,100,46,54,40
L16 2LE,L16,2LE,101,52,49,35
L16 2LF,L16,2LF,94,45,49,33
L16 2LG,L16,2LG,101,54,47,32
L16 2LH,L16,2LH,111,49,62,42
L16 2LJ,L16,2LJ,29,12,17,12
L16 2LL,L16,2LL,82,40,42,30
L16 2LN,L16,2LN,56,28,28,21
L16 2LP,L16,2LP,118,56,62,49
L16 2LQ,L16,2LQ,82,30,52,34
L16 2LR,L16,2LR,43,22,21,16
L16 2LS,L16,2LS,122,55,67,46
L16 2LT,L16,2LT,102,50,52,41
L16 2LU,L16,2LU,34,19,15,12
L16 2LX,L16,2LX,19,8,11,6
L16 2LY,L16,2LY,58,28,30,23
L16 2LZ,L16,2LZ,93,43,50,39
L16 2NB,L16,2NB,99,50,49,37
L16 2ND,L16,2ND,62,30,32,22
L16 2NE,L16,2NE,85,47,38,37
L16 2NF,L16,2NF,40,19,21,16
L16 2NG,L16,2NG,65,36,29,35
L16 2NH,L16,2NH,130,62,68,54
L16 2NJ,L16,2NJ,100,54,46,40
L16 2NL,L16,2NL,119,54,65,47
L16 2NN,L16,2NN,74,35,39,31
L16 2NP,L16,2NP,76,33,43,35
L16 2NQ,L16,2NQ,50,23,27,19
L16 2NR,L16,2NR,24,10,14,10
L16 3GA,L16,3GA,61,27,34,20
L16 3GB,L16,3GB,67,32,35,34
L16 3GD,L16,3GD,207,102,105,79
L16 3GE,L16,3GE,53,27,26,18
L16 3GF,L16,3GF,48,21,27,18
L16 3GG,L16,3GG,37,19,18,16
L16 3GH,L16,3GH,22,11,11,9
L16 3GJ,L16,3GJ,80,39,41,26
L16 3GL,L16,3GL,36,19,17,12
L16 3GN,L16,3GN,33,15,18,14
L16 3GP,L16,3GP,71,32,39,26
L16 3GQ,L16,3GQ,52,28,24,18
L16 3GR,L16,3GR,39,19,20,16
L16 3GS,L16,3GS,42,20,22,13
L16 3GT,L16,3GT,30,12,18,12
L16 3GU,L16,3GU,27,13,14,11
L16 3GW,L16,3GW,19,10,9,8
L16 3NA,L16,3NA,7,2,5,2
L16 3NB,L16,3NB,71,34,37,29
L16 3ND,L16,3ND,119,62,57,48
L16 3NE,L16,3NE,90,45,45,35
L16 3NF,L16,3NF,70,38,32,28
L16 3NG,L16,3NG,39,18,21,18
L16 3NH,L16,3NH,45,22,23,18
L16 3NJ,L16,3NJ,128,62,66,53
L16 3NL,L16,3NL,32,15,17,13
L16 3NN,L16,3NN,72,34,38,26
L16 3NP,L16,3NP,90,39,51,40
L16 3NQ,L16,3NQ,56,30,26,20
L16 3NR,L16,3NR,64,29,35,32
L16 3NS,L16,3NS,55,32,23,20
L16 3NT,L16,3NT,91,47,44,36
L16 3NU,L16,3NU,69,40,29,26
L16 3NW,L16,3NW,153,78,75,64
L16 3NX,L16,3NX,77,37,40,31
L16 3NY,L16,3NY,20,14,6,3
L16 4PA,L16,4PA,20,10,10,8
L16 4PB,L16,4PB,78,35,43,26
L16 4PD,L16,4PD,68,31,37,25
L16 4PE,L16,4PE,78,38,40,29
L16 4PF,L16,4PF,64,33,31,20
L16 4PG,L16,4PG,86,43,43,30
L16 4PH,L16,4PH,107,50,57,40
L16 4PJ,L16,4PJ,103,45,58,42
L16 4PL,L16,4PL,20,11,9,8
L16 4PN,L16,4PN,79,35,44,30
L16 4PP,L16,4PP,70,38,32,25
L16 4PQ,L16,4PQ,51,26,25,15
L16 4PR,L16,4PR,59,29,30,25
L16 4PW,L16,4PW,76,38,38,28
L16 5EA,L16,5EA,23,10,13,9
L16 5EB,L16,5EB,59,29,30,28
L16 5ED,L16,5ED,81,36,45,30
L16 5EE,L16,5EE,72,35,37,26
L16 5EF,L16,5EF,89,43,46,42
L16 5EG,L16,5EG,45,23,22,16
L16 5EH,L16,5EH,35,19,16,13
L16 5EJ,L16,5EJ,26,12,14,10
L16 5EL,L16,5EL,98,46,52,37
L16 5EN,L16,5EN,108,54,54,42
L16 5EP,L16,5EP,16,7,9,6
L16 5EQ,L16,5EQ,47,26,21,21
L16 5ER,L16,5ER,9,3,6,4
L16 5ES,L16,5ES,132,66,66,51
L16 5ET,L16,5ET,73,35,38,36
L16 5EU,L16,5EU,98,56,42,46
L16 5EW,L16,5EW,125,57,68,54
L16 5EX,L16,5EX,26,14,12,10
L16 5EZ,L16,5EZ,27,12,15,10
L16 5HA,L16,5HA,25,14,11,12
L16 5HE,L16,5HE,38,21,17,11
L16 5HF,L16,5HF,107,55,52,36
L16 5HG,L16,5HG,102,47,55,35
L16 6AD,L16,6AD,57,28,29,27
L16 6AE,L16,6AE,131,62,69,54
L16 6AF,L16,6AF,86,41,45,36
L16 6AG,L16,6AG,59,25,34,24
L16 6AH,L16,6AH,6,2,4,2
L16 6AJ,L16,6AJ,99,46,53,31
L16 6AL,L16,6AL,21,11,10,8
L16 6AN,L16,6AN,111,55,56,49
L16 6AP,L16,6AP,39,15,24,10
L16 6AQ,L16,6AQ,89,39,50,38
L16 6AR,L16,6AR,54,30,24,18
L16 6AS,L16,6AS,74,36,38,24
L16 6AT,L16,6AT,74,32,42,30
L16 6AU,L16,6AU,20,11,9,8
L16 6AW,L16,6AW,44,19,25,17
L16 6AX,L16,6AX,47,24,23,22
L16 6AY,L16,6AY,86,45,41,32
L16 6AZ,L16,6AZ,72,37,35,30
L16 7PA,L16,7PA,39,19,20,18
L16 7PD,L16,7PD,49,22,27,17
L16 7PE,L16,7PE,54,28,26,22
L16 7PF,L16,7PF,47,20,27,18
L16 7PG,L16,7PG,82,40,42,29
L16 7PH,L16,7PH,22,9,13,8
L16 7PJ,L16,7PJ,70,37,33,26
L16 7PL,L16,7PL,75,41,34,22
L16 7PN,L16,7PN,46,24,22,16
L16 7PP,L16,7PP,51,22,29,20
L16 7PQ,L16,7PQ,51,23,28,19
L16 7PR,L16,7PR,89,42,47,30
L16 7PS,L16,7PS,57,33,24,21
L16 7PT,L16,7PT,36,16,20,14
L16 7PU,L16,7PU,59,30,29,23
L16 7PW,L16,7PW,60,33,27,21
L16 7PX,L16,7PX,71,38,33,25
L16 7PY,L16,7PY,70,33,37,30
L16 7PZ,L16,7PZ,57,26,31,21
L16 7QA,L16,7QA,44,17,27,19
L16 7QB,L16,7QB,34,19,15,14
L16 7QD,L16,7QD,54,23,31,22
L16 7QE,L16,7QE,44,22,22,19
L16 7QF,L16,7QF,65,30,35,28
L16 7QG,L16,7QG,16,5,11,6
L16 7QH,L16,7QH,55,26,29,20
L16 7QJ,L16,7QJ,51,23,28,17
L16 7QL,L16,7QL,45,23,22,22
L16 7QN,L16,7QN,73,35,38,24
L16 7QP,L16,7QP,40,21,19,16
L16 7QQ,L16,7QQ,88,40,48,30
L16 7QR,L16,7QR,76,38,38,27
L16 7QS,L16,7QS,82,45,37,30
L16 7QT,L16,7QT,46,22,24,22
L16 7QW,L16,7QW,46,22,24,19
L16 8GA,L16,8GA,5,3,2,1
L16 8NA,L16,8NA,40,20,20,15
L16 8NB,L16,8NB,49,21,28,11
L16 8NE,L16,8NE,78,32,46,57
L16 8NF,L16,8NF,25,0,25,1
L16 8NH,L16,8NH,65,36,29,20
L16 8NJ,L16,8NJ,64,30,34,23
L16 8NL,L16,8NL,74,30,44,30
L16 8NN,L16,8NN,88,38,50,35
L16 8NP,L16,8NP,85,40,45,30
L16 8NQ,L16,8NQ,5,5,0,0
L16 8NR,L16,8NR,82,33,49,32
L16 8NS,L16,8NS,62,27,35,23
L16 8NT,L16,8NT,58,28,30,18
L16 8NU,L16,8NU,41,17,24,20
L16 8NW,L16,8NW,75,29,46,36
L16 8NX,L16,8NX,51,21,30,19
L16 8NY,L16,8NY,51,25,26,18
L16 8NZ,L16,8NZ,58,30,28,19
L16 8PA,L16,8PA,52,26,26,20
L16 8PB,L16,8PB,49,26,23,15
L16 8PD,L16,8PD,39,18,21,16
L16 9JA,L16,9JA,87,43,44,36
L16 9JB,L16,9JB,55,22,33,18
L16 9JD,L16,9JD,498,128,370,1
L16 9JE,L16,9JE,61,28,33,30
L16 9JF,L16,9JF,31,15,16,11
L16 9JG,L16,9JG,89,39,50,33
L16 9JH,L16,9JH,61,28,33,30
L16 9JJ,L16,9JJ,75,38,37,29
L16 9JL,L16,9JL,123,60,63,43
L16 9JN,L16,9JN,75,32,43,26
L16 9JP,L16,9JP,2,1,1,2
L16 9JQ,L16,9JQ,103,52,51,42
L16 9JR,L16,9JR,31,11,20,13
L16 9JS,L16,9JS,51,26,25,19
L16 9JT,L16,9JT,41,21,20,12
L16 9JU,L16,9JU,23,10,13,11
L16 9JW,L16,9JW,77,31,46,27
L17 0AA,L17,0AA,75,29,46,33
L17 0AB,L17,0AB,96,43,53,41
L17 0AD,L17,0AD,82,37,45,37
L17 0AE,L17,0AE,74,36,38,30
L17 0AF,L17,0AF,56,27,29,21
L17 0AG,L17,0AG,99,48,51,40
L17 0AH,L17,0AH,111,51,60,45
L17 0AJ,L17,0AJ,65,34,31,27
L17 0AL,L17,0AL,24,11,13,11
L17 0AN,L17,0AN,80,42,38,12
L17 0AP,L17,0AP,65,36,29,20
L17 0AQ,L17,0AQ,64,28,36,26
L17 0AR,L17,0AR,28,15,13,12
L17 0AS,L17,0AS,93,50,43,39
L17 0AT,L17,0AT,62,33,29,24
L17 0AU,L17,0AU,50,25,25,24
L17 0AW,L17,0AW,52,25,27,16
L17 0AX,L17,0AX,73,34,39,30
L17 0AY,L17,0AY,77,36,41,36
L17 0AZ,L17,0AZ,46,20,26,24
L17 0BA,L17,0BA,101,48,53,42
L17 0BB,L17,0BB,20,9,11,11
L17 0BD,L17,0BD,92,40,52,38
L17 0BE,L17,0BE,54,30,24,18
L17 0BG,L17,0BG,56,31,25,21
L17 0BH,L17,0BH,48,21,27,16
L17 0BJ,L17,0BJ,44,25,19,28
L17 0BL,L17,0BL,31,23,8,15
L17 0BP,L17,0BP,13,8,5,9
L17 0BQ,L17,0BQ,51,23,28,19
L17 0BR,L17,0BR,56,28,28,22
L17 0BS,L17,0BS,57,32,25,31
L17 0BT,L17,0BT,87,48,39,39
L17 0BU,L17,0BU,33,21,12,16
L17 0BX,L17,0BX,42,21,21,19
L17 0BY,L17,0BY,69,24,45,15
L17 0BZ,L17,0BZ,83,39,44,31
L17 0DA,L17,0DA,45,21,24,20
L17 0DB,L17,0DB,56,28,28,21
L17 0DD,L17,0DD,60,30,30,26
L17 0DE,L17,0DE,110,61,49,76
L17 0DF,L17,0DF,38,25,13,22
L17 0DG,L17,0DG,54,18,36,45
L17 0DH,L17,0DH,74,33,41,32
L17 0DJ,L17,0DJ,55,24,31,22
L17 0DN,L17,0DN,12,8,4,6
L17 0DP,L17,0DP,17,10,7,11
L17 0DR,L17,0DR,70,36,34,39
L17 0DS,L17,0DS,84,37,47,44
L17 0DT,L17,0DT,88,39,49,34
L17 0DU,L17,0DU,31,14,17,16
L17 0DX,L17,0DX,14,8,6,6
L17 0DY,L17,0DY,43,25,18,33
L17 0DZ,L17,0DZ,65,36,29,50
L17 0EA,L17,0EA,64,27,37,34
L17 0EB,L17,0EB,46,28,18,36
L17 0ED,L17,0ED,67,42,25,45
L17 0EE,L17,0EE,43,24,19,31
L17 0EF,L17,0EF,17,9,8,10
L17 0EG,L17,0EG,107,52,55,57
L17 0EH,L17,0EH,97,40,57,51
L17 0EJ,L17,0EJ,23,11,12,9
L17 0EL,L17,0EL,58,33,25,32
L17 0EN,L17,0EN,66,24,42,42
L17 0EQ,L17,0EQ,118,45,73,81
L17 0ES,L17,0ES,38,18,20,22
L17 0ET,L17,0ET,20,8,12,14
L17 0EU,L17,0EU,19,6,13,13
L17 0EW,L17,0EW,9,5,4,6
L17 0HG,L17,0HG,73,33,40,60
L17 1AB,L17,1AB,33,14,19,22
L17 1AD,L17,1AD,28,15,13,25
L17 1AE,L17,1AE,3,2,1,2
L17 1AF,L17,1AF,4,3,1,4
L17 1AG,L17,1AG,3,1,2,1
L17 1AH,L17,1AH,393,205,188,9
L17 1AJ,L17,1AJ,79,47,32,56
L17 1AL,L17,1AL,75,44,31,45
L17 1AN,L17,1AN,107,33,74,51
L17 1AR,L17,1AR,25,14,11,20
L17 1AT,L17,1AT,55,31,24,47
L17 1AW,L17,1AW,27,18,9,19
L17 1AX,L17,1AX,64,30,34,39
L17 1AZ,L17,1AZ,29,12,17,27
L17 1BD,L17,1BD,10,5,5,7
L17 2AA,L17,2AA,101,50,51,60
L17 2AB,L17,2AB,140,93,47,86
L17 2AD,L17,2AD,87,34,53,5
L17 2AE,L17,2AE,81,44,37,29
L17 2AF,L17,2AF,78,50,28,28
L17 2AG,L17,2AG,67,40,27,29
L17 2AH,L17,2AH,79,33,46,25
L17 2AJ,L17,2AJ,96,52,44,31
L17 2AL,L17,2AL,114,51,63,26
L17 2AN,L17,2AN,97,43,54,26
L17 2AP,L17,2AP,134,67,67,32
L17 2AQ,L17,2AQ,60,34,26,29
L17 2AR,L17,2AR,88,46,42,29
L17 2AS,L17,2AS,79,39,40,37
L17 2AT,L17,2AT,73,35,38,25
L17 2AU,L17,2AU,31,11,20,12
L17 2AW,L17,2AW,87,45,42,24
L17 2AX,L17,2AX,76,29,47,21
L17 2AY,L17,2AY,6,2,4,2
L17 2AZ,L17,2AZ,21,7,14,17
L17 2BJ,L17,2BJ,139,60,79,56
L17 3AA,L17,3AA,81,52,29,42
L17 3AF,L17,3AF,79,44,35,59
L17 3AG,L17,3AG,37,19,18,28
L17 3AH,L17,3AH,50,27,23,27
L17 3AJ,L17,3AJ,42,23,19,32
L17 3AN,L17,3AN,89,41,48,59
L17 3AQ,L17,3AQ,44,29,15,30
L17 3AR,L17,3AR,94,51,43,62
L17 3AS,L17,3AS,70,29,41,37
L17 3AT,L17,3AT,27,14,13,19
L17 3AU,L17,3AU,77,50,27,30
L17 3AW,L17,3AW,26,14,12,17
L17 3AX,L17,3AX,85,43,42,54
L17 3AY,L17,3AY,66,40,26,28
L17 3AZ,L17,3AZ,55,25,30,16
L17 3BA,L17,3BA,37,14,23,14
L17 3BB,L17,3BB,57,24,33,19
L17 3BD,L17,3BD,9,6,3,7
L17 3BE,L17,3BE,113,56,57,78
L17 3BG,L17,3BG,77,46,31,54
L17 3BH,L17,3BH,68,42,26,48
L17 3BL,L17,3BL,92,57,35,57
L17 3BP,L17,3BP,129,69,60,77
L17 3BQ,L17,3BQ,96,57,39,67
L17 3BT,L17,3BT,111,56,55,40
L17 3BU,L17,3BU,126,75,51,75
L17 3BX,L17,3BX,45,32,13,20
L17 3BY,L17,3BY,81,42,39,49
L17 3DA,L17,3DA,37,20,17,20
L17 3DQ,L17,3DQ,29,18,11,27
L17 4JA,L17,4JA,86,48,38,53
L17 4JB,L17,4JB,34,22,12,30
L17 4JD,L17,4JD,20,12,8,17
L17 4JE,L17,4JE,111,62,49,54
L17 4JG,L17,4JG,97,56,41,37
L17 4JH,L17,4JH,122,56,66,61
L17 4JJ,L17,4JJ,54,27,27,36
L17 4JL,L17,4JL,74,40,34,53
L17 4JN,L17,4JN,67,36,31,48
L17 4JP,L17,4JP,111,60,51,94
L17 4JQ,L17,4JQ,33,16,17,19
L17 4JS,L17,4JS,24,8,16,19
L17 4JT,L17,4JT,35,21,14,13
L17 4JU,L17,4JU,66,35,31,32
L17 4JW,L17,4JW,37,20,17,26
L17 4JX,L17,4JX,29,21,8,26
L17 4JY,L17,4JY,31,23,8,29
L17 4LA,L17,4LA,79,52,27,50
L17 4LB,L17,4LB,95,41,54,34
L17 4LD,L17,4LD,51,32,19,29
L17 4LE,L17,4LE,27,19,8,19
L17 4LF,L17,4LF,4,2,2,2
L17 4LG,L17,4LG,78,38,40,34
L17 4LH,L17,4LH,66,31,35,25
L17 4LJ,L17,4LJ,12,11,1,12
L17 4LL,L17,4LL,36,26,10,27
L17 4LQ,L17,4LQ,72,32,40,28
L17 4LR,L17,4LR,28,13,15,14
L17 4LS,L17,4LS,36,20,16,32
L17 4LU,L17,4LU,19,5,14,18
L17 5AA,L17,5AA,51,25,26,26
L17 5AD,L17,5AD,79,31,48,26
L17 5AF,L17,5AF,12,7,5,4
L17 5AG,L17,5AG,55,23,32,31
L17 5AH,L17,5AH,28,13,15,16
L17 5AJ,L17,5AJ,10,6,4,6
L17 5AL,L17,5AL,7,7,0,7
L17 5AP,L17,5AP,18,9,9,13
L17 5AQ,L17,5AQ,7,5,2,3
L17 5AR,L17,5AR,11,10,1,11
L17 5AT,L17,5AT,14,7,7,5
L17 5AW,L17,5AW,92,51,41,55
L17 5AX,L17,5AX,67,32,35,36
L17 5AY,L17,5AY,43,20,23,37
L17 5BB,L17,5BB,50,25,25,19
L17 5BD,L17,5BD,85,44,41,34
L17 5BL,L17,5BL,118,54,64,44
L17 5BN,L17,5BN,79,40,39,32
L17 5BR,L17,5BR,31,17,14,11
L17 5BS,L17,5BS,24,11,13,7
L17 5BT,L17,5BT,42,20,22,15
L17 5BU,L17,5BU,7,3,4,3
L17 5BX,L17,5BX,53,27,26,19
L17 5BY,L17,5BY,32,16,16,10
L17 5BZ,L17,5BZ,62,33,29,24
L17 5DB,L17,5DB,75,35,40,24
L17 5DD,L17,5DD,14,5,9,6
L17 5DE,L17,5DE,17,10,7,9
L17 5DF,L17,5DF,34,15,19,12
L17 6AA,L17,6AA,29,13,16,12
L17 6AD,L17,6AD,46,23,23,22
L17 6AE,L17,6AE,44,20,24,16
L17 6AG,L17,6AG,69,35,34,24
L17 6AH,L17,6AH,33,14,19,16
L17 6AJ,L17,6AJ,35,15,20,13
L17 6AL,L17,6AL,39,17,22,16
L17 6AN,L17,6AN,63,33,30,20
L17 6AP,L17,6AP,84,36,48,39
L17 6AQ,L17,6AQ,26,12,14,14
L17 6AR,L17,6AR,87,41,46,37
L17 6AS,L17,6AS,67,34,33,24
L17 6AT,L17,6AT,54,23,31,22
L17 6AU,L17,6AU,24,9,15,11
L17 6AW,L17,6AW,62,35,27,23
L17 6AY,L17,6AY,37,16,21,17
L17 6AZ,L17,6AZ,61,33,28,20
L17 6BA,L17,6BA,22,12,10,10
L17 6BB,L17,6BB,67,28,39,25
L17 6BD,L17,6BD,81,32,49,0
L17 6BE,L17,6BE,14,7,7,8
L17 6BG,L17,6BG,32,18,14,14
L17 6BH,L17,6BH,50,24,26,27
L17 6BJ,L17,6BJ,25,14,11,9
L17 6BL,L17,6BL,23,12,11,8
L17 6BN,L17,6BN,38,21,17,13
L17 6BP,L17,6BP,17,7,10,7
L17 6BQ,L17,6BQ,2,0,2,2
L17 6BR,L17,6BR,11,6,5,4
L17 6BS,L17,6BS,18,11,7,6
L17 6BT,L17,6BT,51,25,26,23
L17 6BU,L17,6BU,11,6,5,5
L17 6BW,L17,6BW,34,21,13,13
L17 6BX,L17,6BX,57,32,25,23
L17 6BY,L17,6BY,63,27,36,22
L17 6BZ,L17,6BZ,62,31,31,26
L17 6DA,L17,6DA,49,22,27,21
L17 6DB,L17,6DB,17,10,7,10
L17 6DD,L17,6DD,66,35,31,39
L17 6DE,L17,6DE,77,32,45,40
L17 6DF,L17,6DF,76,32,44,45
L17 6DG,L17,6DG,31,11,20,17
L17 6DH,L17,6DH,67,35,32,38
L17 6DJ,L17,6DJ,38,17,21,19
L17 6DN,L17,6DN,29,12,17,24
L17 6DP,L17,6DP,25,15,10,9
L17 6DQ,L17,6DQ,73,34,39,34
L17 6DW,L17,6DW,15,7,8,7
L17 6DY,L17,6DY,64,34,30,22
L17 6EH,L17,6EH,21,14,7,7
L17 6ER,L17,6ER,111,64,47,44
L17 6ES,L17,6ES,49,23,26,17
L17 6ET,L17,6ET,21,14,7,7
L17 6EU,L17,6EU,23,11,12,12
L17 6EW,L17,6EW,16,6,10,5
L17 6EX,L17,6EX,51,24,27,15
L17 6GA,L17,6GA,25,14,11,18
L17 6GB,L17,6GB,55,30,25,36
L17 6GD,L17,6GD,81,42,39,52
L17 6GE,L17,6GE,67,33,34,44
L17 7AD,L17,7AD,74,33,41,36
L17 7AE,L17,7AE,85,43,42,32
L17 7AF,L17,7AF,86,43,43,32
L17 7AG,L17,7AG,71,38,33,32
L17 7AH,L17,7AH,77,39,38,32
L17 7AJ,L17,7AJ,96,39,57,38
L17 7AL,L17,7AL,149,64,85,79
L17 7AN,L17,7AN,44,19,25,20
L17 7AQ,L17,7AQ,83,37,46,32
L17 7AR,L17,7AR,50,25,25,27
L17 7AS,L17,7AS,77,35,42,31
L17 7AT,L17,7AT,57,30,27,26
L17 7AU,L17,7AU,5,3,2,2
L17 7AW,L17,7AW,39,18,21,25
L17 7AY,L17,7AY,33,22,11,19
L17 7AZ,L17,7AZ,41,18,23,27
L17 7BA,L17,7BA,12,5,7,4
L17 7BB,L17,7BB,29,17,12,11
L17 7BD,L17,7BD,151,72,79,57
L17 7BE,L17,7BE,80,44,36,37
L17 7BG,L17,7BG,46,21,25,19
L17 7BJ,L17,7BJ,79,39,40,34
L17 7BL,L17,7BL,100,49,51,36
L17 7BN,L17,7BN,32,23,9,16
L17 7BP,L17,7BP,30,18,12,14
L17 7BQ,L17,7BQ,58,35,23,19
L17 7BR,L17,7BR,26,15,11,12
L17 7BT,L17,7BT,84,43,41,41
L17 7BU,L17,7BU,101,51,50,44
L17 7BX,L17,7BX,60,26,34,27
L17 7BY,L17,7BY,75,43,32,32
L17 7BZ,L17,7BZ,53,32,21,26
L17 7DA,L17,7DA,83,41,42,41
L17 7DB,L17,7DB,70,30,40,34
L17 7DD,L17,7DD,56,31,25,27
L17 7DE,L17,7DE,65,31,34,31
L17 7DF,L17,7DF,59,30,29,27
L17 7DG,L17,7DG,44,21,23,23
L17 7DH,L17,7DH,114,55,59,41
L17 7DJ,L17,7DJ,87,39,48,37
L17 7DL,L17,7DL,57,27,30,25
L17 7DN,L17,7DN,99,47,52,43
L17 7DP,L17,7DP,96,48,48,44
L17 7DQ,L17,7DQ,113,54,59,51
L17 7DR,L17,7DR,78,40,38,34
L17 7DT,L17,7DT,51,25,26,20
L17 7DU,L17,7DU,90,37,53,43
L17 7DW,L17,7DW,57,23,34,24
L17 7DX,L17,7DX,55,24,31,23
L17 7DY,L17,7DY,88,35,53,45
L17 7ED,L17,7ED,52,29,23,16
L17 7EE,L17,7EE,67,32,35,20
L17 7EG,L17,7EG,38,15,23,15
L17 7EN,L17,7EN,49,27,22,17
L17 7EP,L17,7EP,36,21,15,16
L17 7ER,L17,7ER,36,20,16,13
L17 7ES,L17,7ES,76,44,32,33
L17 7ET,L17,7ET,80,36,44,31
L17 7EU,L17,7EU,22,9,13,7
L17 7EW,L17,7EW,36,17,19,20
L17 7EX,L17,7EX,30,14,16,10
L17 7EY,L17,7EY,30,14,16,11
L17 7HB,L17,7HB,22,8,14,11
L17 7HD,L17,7HD,14,6,8,7
L17 7HP,L17,7HP,49,23,26,15
L17 7HR,L17,7HR,90,38,52,34
L17 7HW,L17,7HW,44,18,26,28
L17 7JQ,L17,7JQ,327,124,203,1
L17 8BA,L17,8BA,22,13,9,14
L17 8SL,L17,8SL,31,11,20,15
L17 8SN,L17,8SN,17,8,9,12
L17 8SW,L17,8SW,6,4,2,4
L17 8TA,L17,8TA,105,55,50,66
L17 8TB,L17,8TB,48,20,28,35
L17 8TD,L17,8TD,81,44,37,52
L17 8TE,L17,8TE,83,51,32,58
L17 8TG,L17,8TG,21,11,10,16
L17 8TH,L17,8TH,30,24,6,28
L17 8TJ,L17,8TJ,112,60,52,62
L17 8TL,L17,8TL,24,13,11,21
L17 8TN,L17,8TN,67,40,27,45
L17 8TP,L17,8TP,11,5,6,5
L17 8TQ,L17,8TQ,32,14,18,18
L17 8TR,L17,8TR,90,56,34,64
L17 8TS,L17,8TS,57,41,16,39
L17 8TT,L17,8TT,49,34,15,40
L17 8TU,L17,8TU,55,36,19,38
L17 8TX,L17,8TX,69,40,29,40
L17 8TY,L17,8TY,65,32,33,41
L17 8TZ,L17,8TZ,25,18,7,18
L17 8UA,L17,8UA,53,23,30,21
L17 8UB,L17,8UB,36,17,19,22
L17 8UD,L17,8UD,57,21,36,35
L17 8UE,L17,8UE,76,40,36,44
L17 8UF,L17,8UF,62,35,27,42
L17 8UG,L17,8UG,93,50,43,73
L17 8UH,L17,8UH,89,56,33,51
L17 8UJ,L17,8UJ,123,70,53,76
L17 8UL,L17,8UL,25,14,11,18
L17 8UP,L17,8UP,8,2,6,6
L17 8UQ,L17,8UQ,80,46,34,55
L17 8UR,L17,8UR,9,7,2,5
L17 8US,L17,8US,7,5,2,5
L17 8UT,L17,8UT,7,4,3,5
L17 8UU,L17,8UU,48,26,22,28
L17 8UW,L17,8UW,7,5,2,3
L17 8UX,L17,8UX,13,7,6,10
L17 8UY,L17,8UY,2,1,1,2
L17 8UZ,L17,8UZ,61,27,34,27
L17 8XB,L17,8XB,19,10,9,10
L17 8XD,L17,8XD,116,57,59,44
L17 8XE,L17,8XE,57,31,26,42
L17 8XF,L17,8XF,67,30,37,45
L17 8XG,L17,8XG,51,30,21,24
L17 8XH,L17,8XH,39,22,17,16
L17 8XJ,L17,8XJ,9,4,5,5
L17 8XL,L17,8XL,10,4,6,6
L17 8XN,L17,8XN,66,34,32,44
L17 8XQ,L17,8XQ,43,23,20,24
L17 8XT,L17,8XT,82,31,51,40
L17 8XU,L17,8XU,46,26,20,23
L17 8XW,L17,8XW,59,35,24,41
L17 8XX,L17,8XX,115,54,61,80
L17 8XY,L17,8XY,28,14,14,20
L17 8XZ,L17,8XZ,66,28,38,43
L17 8YD,L17,8YD,12,8,4,11
L17 8YE,L17,8YE,3,3,0,2
L17 8YG,L17,8YG,85,44,41,40
L17 8YQ,L17,8YQ,13,10,3,12
L17 8YS,L17,8YS,30,9,21,29
L17 9PA,L17,9PA,14,4,10,10
L17 9PB,L17,9PB,36,14,22,24
L17 9PD,L17,9PD,45,19,26,23
L17 9PE,L17,9PE,8,6,2,5
L17 9PG,L17,9PG,4,3,1,3
L17 9PH,L17,9PH,2,1,1,1
L17 9PJ,L17,9PJ,54,28,26,25
L17 9PN,L17,9PN,28,10,18,18
L17 9PP,L17,9PP,11,4,7,5
L17 9PR,L17,9PR,70,37,33,26
L17 9PS,L17,9PS,71,31,40,24
L17 9PT,L17,9PT,67,35,32,24
L17 9PU,L17,9PU,77,37,40,31
L17 9PW,L17,9PW,59,35,24,35
L17 9PX,L17,9PX,74,38,36,31
L17 9PY,L17,9PY,26,13,13,11
L17 9PZ,L17,9PZ,69,40,29,25
L17 9QA,L17,9QA,69,34,35,26
L17 9QB,L17,9QB,21,11,10,8
L17 9QD,L17,9QD,22,12,10,9
L17 9QE,L17,9QE,103,55,48,49
L17 9QF,L17,9QF,96,48,48,32
L17 9QG,L17,9QG,107,55,52,37
L17 9QH,L17,9QH,87,41,46,36
L17 9QJ,L17,9QJ,73,37,36,31
L17 9QL,L17,9QL,109,68,41,43
L17 9QN,L17,9QN,89,53,36,33
L17 9QP,L17,9QP,95,42,53,35
L17 9QQ,L17,9QQ,88,38,50,40
L17 9QR,L17,9QR,45,22,23,21
L17 9QS,L17,9QS,39,15,24,20
L17 9QT,L17,9QT,20,10,10,12
L17 9QU,L17,9QU,147,68,79,75
L17 9QW,L17,9QW,83,47,36,32
L17 9QX,L17,9QX,36,17,19,21
L17 9QZ,L17,9QZ,27,9,18,14
L17 9RA,L17,9RA,33,14,19,17
L17 9RB,L17,9RB,56,31,25,31
L17 9RH,L17,9RH,27,10,17,12
L17 9RQ,L17,9RQ,22,14,8,8
L18 0HA,L18,0HA,84,37,47,32
L18 0HB,L18,0HB,51,26,25,17
L18 0HD,L18,0HD,2,1,1,1
L18 0HE,L18,0HE,37,15,22,11
L18 0HF,L18,0HF,32,19,13,13
L18 0HG,L18,0HG,93,52,41,36
L18 0HH,L18,0HH,26,13,13,7
L18 0HJ,L18,0HJ,76,43,33,30
L18 0HN,L18,0HN,65,34,31,24
L18 0HP,L18,0HP,73,33,40,32
L18 0HQ,L18,0HQ,72,33,39,27
L18 0HR,L18,0HR,80,37,43,35
L18 0HS,L18,0HS,76,37,39,31
L18 0HT,L18,0HT,60,28,32,27
L18 0HU,L18,0HU,64,27,37,27
L18 0HW,L18,0HW,73,41,32,23
L18 0HX,L18,0HX,37,21,16,14
L18 0HY,L18,0HY,102,54,48,33
L18 0HZ,L18,0HZ,91,46,45,40
L18 0JA,L18,0JA,57,32,25,26
L18 1DA,L18,1DA,68,35,33,30
L18 1DB,L18,1DB,73,34,39,36
L18 1DD,L18,1DD,81,43,38,43
L18 1DE,L18,1DE,56,33,23,18
L18 1DF,L18,1DF,74,31,43,27
L18 1DG,L18,1DG,14,8,6,6
L18 1DH,L18,1DH,78,33,45,35
L18 1DJ,L18,1DJ,72,36,36,25
L18 1DL,L18,1DL,67,39,28,27
L18 1DN,L18,1DN,47,27,20,23
L18 1DP,L18,1DP,90,49,41,33
L18 1DQ,L18,1DQ,28,5,23,7
L18 1DR,L18,1DR,60,38,22,21
L18 1DS,L18,1DS,77,39,38,31
L18 1DT,L18,1DT,49,25,24,22
L18 1DU,L18,1DU,32,12,20,16
L18 1DW,L18,1DW,62,32,30,17
L18 1DX,L18,1DX,18,6,12,12
L18 1DY,L18,1DY,73,46,27,28
L18 1DZ,L18,1DZ,82,32,50,30
L18 1EA,L18,1EA,111,46,65,26
L18 1EB,L18,1EB,102,63,39,29
L18 1ED,L18,1ED,89,50,39,22
L18 1EE,L18,1EE,76,37,39,31
L18 1EF,L18,1EF,77,39,38,30
L18 1EG,L18,1EG,24,9,15,9
L18 1EH,L18,1EH,56,28,28,27
L18 1EJ,L18,1EJ,56,21,35,15
L18 1EL,L18,1EL,121,59,62,33
L18 1EN,L18,1EN,86,41,45,46
L18 1EP,L18,1EP,114,54,60,43
L18 1EQ,L18,1EQ,3,2,1,1
L18 1ER,L18,1ER,60,31,29,26
L18 1ES,L18,1ES,45,12,33,16
L18 1ET,L18,1ET,81,44,37,32
L18 1EU,L18,1EU,97,55,42,91
L18 1EW,L18,1EW,80,43,37,36
L18 1EX,L18,1EX,64,35,29,19
L18 1EY,L18,1EY,84,44,40,33
L18 1EZ,L18,1EZ,73,30,43,30
L18 1HA,L18,1HA,57,30,27,21
L18 1HB,L18,1HB,92,43,49,42
L18 1HD,L18,1HD,72,39,33,29
L18 1HE,L18,1HE,16,7,9,7
L18 1HF,L18,1HF,20,9,11,11
L18 1HG,L18,1HG,101,49,52,35
L18 1HH,L18,1HH,37,16,21,20
L18 1HJ,L18,1HJ,147,69,78,112
L18 1HL,L18,1HL,79,41,38,36
L18 1HN,L18,1HN,75,30,45,23
L18 1HP,L18,1HP,80,30,50,26
L18 1HR,L18,1HR,106,39,67,32
L18 1HS,L18,1HS,69,27,42,23
L18 1HT,L18,1HT,45,21,24,15
L18 1HU,L18,1HU,104,54,50,35
L18 1HX,L18,1HX,53,27,26,22
L18 1HY,L18,1HY,73,22,51,24
L18 1HZ,L18,1HZ,47,30,17,20
L18 1JA,L18,1JA,29,13,16,10
L18 1JB,L18,1JB,29,10,19,8
L18 1JD,L18,1JD,64,31,33,23
L18 1JE,L18,1JE,59,36,23,19
L18 1JF,L18,1JF,58,34,24,22
L18 1JG,L18,1JG,81,42,39,27
L18 1JH,L18,1JH,144,77,67,110
L18 1JJ,L18,1JJ,94,61,33,80
L18 1JL,L18,1JL,71,36,35,26
L18 1JN,L18,1JN,68,29,39,27
L18 1JP,L18,1JP,68,29,39,26
L18 1JQ,L18,1JQ,67,32,35,27
L18 1JR,L18,1JR,36,17,19,17
L18 1JS,L18,1JS,49,22,27,27
L18 1JT,L18,1JT,54,25,29,27
L18 1JU,L18,1JU,58,31,27,26
L18 1JW,L18,1JW,59,31,28,20
L18 1JX,L18,1JX,33,17,16,15
L18 1JY,L18,1JY,63,26,37,30
L18 1JZ,L18,1JZ,57,30,27,21
L18 1LA,L18,1LA,62,24,38,30
L18 1LB,L18,1LB,73,38,35,32
L18 1LD,L18,1LD,102,48,54,42
L18 1LE,L18,1LE,52,23,29,20
L18 1LF,L18,1LF,86,37,49,26
L18 1LN,L18,1LN,7,2,5,3
L18 1LS,L18,1LS,14,4,10,5
L18 1LT,L18,1LT,86,45,41,37
L18 1LU,L18,1LU,106,54,52,43
L18 1LW,L18,1LW,22,10,12,9
L18 1LX,L18,1LX,62,27,35,29
L18 1LY,L18,1LY,32,18,14,16
L18 1LZ,L18,1LZ,10,5,5,6
L18 2DA,L18,2DA,5,4,1,5
L18 2DD,L18,2DD,6,3,3,2
L18 2DL,L18,2DL,46,24,22,18
L18 2DN,L18,2DN,68,33,35,25
L18 2DP,L18,2DP,38,17,21,19
L18 2DR,L18,2DR,68,33,35,28
L18 2DS,L18,2DS,13,6,7,7
L18 2DT,L18,2DT,64,36,28,19
L18 2DU,L18,2DU,45,18,27,16
L18 2DW,L18,2DW,53,18,35,22
L18 2DX,L18,2DX,21,8,13,7
L18 2DY,L18,2DY,43,19,24,16
L18 2EA,L18,2EA,39,22,17,15
L18 2EB,L18,2EB,73,30,43,32
L18 2ED,L18,2ED,94,35,59,42
L18 2EE,L18,2EE,43,28,15,16
L18 2EF,L18,2EF,56,26,30,26
L18 2EG,L18,2EG,69,32,37,23
L18 2EH,L18,2EH,103,53,50,35
L18 2EJ,L18,2EJ,52,22,30,16
L18 2EL,L18,2EL,61,31,30,22
L18 2EN,L18,2EN,52,28,24,26
L18 2EP,L18,2EP,44,19,25,26
L18 2EQ,L18,2EQ,70,26,44,27
L18 2ER,L18,2ER,34,17,17,12
L18 2ET,L18,2ET,32,14,18,14
L18 2EU,L18,2EU,31,12,19,23
L18 2EW,L18,2EW,61,28,33,34
L18 2EX,L18,2EX,44,19,25,14
L18 2EY,L18,2EY,6,3,3,3
L18 2EZ,L18,2EZ,52,25,27,19
L18 2FP,L18,2FP,8,3,5,4
L18 2HA,L18,2HA,41,19,22,12
L18 2HB,L18,2HB,67,33,34,24
L18 2HD,L18,2HD,38,17,21,10
L18 2HE,L18,2HE,94,48,46,32
L18 2HY,L18,2HY,40,14,26,27
L18 2JL,L18,2JL,47,23,24,16
L18 2JW,L18,2JW,31,18,13,8
L18 3EA,L18,3EA,55,28,27,21
L18 3EB,L18,3EB,72,37,35,26
L18 3ED,L18,3ED,65,35,30,23
L18 3EE,L18,3EE,15,5,10,9
L18 3EF,L18,3EF,28,15,13,11
L18 3EG,L18,3EG,57,26,31,24
L18 3EH,L18,3EH,57,25,32,27
L18 3EJ,L18,3EJ,64,30,34,19
L18 3EL,L18,3EL,67,37,30,22
L18 3EN,L18,3EN,72,30,42,23
L18 3EP,L18,3EP,58,30,28,17
L18 3EQ,L18,3EQ,58,26,32,22
L18 3ER,L18,3ER,91,38,53,25
L18 3ES,L18,3ES,9,2,7,8
L18 3ET,L18,3ET,3,1,2,3
L18 3EU,L18,3EU,25,12,13,11
L18 3EW,L18,3EW,96,52,44,30
L18 3EX,L18,3EX,60,30,30,21
L18 3EY,L18,3EY,19,12,7,13
L18 3EZ,L18,3EZ,33,12,21,21
L18 3HA,L18,3HA,71,37,34,26
L18 3HB,L18,3HB,49,23,26,15
L18 3HD,L18,3HD,38,19,19,17
L18 3HE,L18,3HE,42,18,24,14
L18 3HF,L18,3HF,68,32,36,26
L18 3HG,L18,3HG,42,18,24,27
L18 3HH,L18,3HH,117,56,61,41
L18 3HJ,L18,3HJ,46,23,23,18
L18 3HL,L18,3HL,71,34,37,27
L18 3HN,L18,3HN,38,19,19,14
L18 3HP,L18,3HP,52,29,23,15
L18 3HQ,L18,3HQ,33,14,19,21
L18 3HR,L18,3HR,3,1,2,1
L18 3HU,L18,3HU,30,10,20,3
L18 3HW,L18,3HW,12,6,6,5
L18 3HX,L18,3HX,38,20,18,14
L18 3HY,L18,3HY,36,18,18,14
L18 3HZ,L18,3HZ,25,8,17,19
L18 3JA,L18,3JA,10,3,7,7
L18 3JE,L18,3JE,29,11,18,9
L18 3JF,L18,3JF,47,25,22,14
L18 3JG,L18,3JG,73,35,38,27
L18 3JL,L18,3JL,31,18,13,10
L18 3JN,L18,3JN,68,36,32,31
L18 3JR,L18,3JR,49,22,27,16
L18 3JS,L18,3JS,51,26,25,17
L18 3JT,L18,3JT,11,7,4,5
L18 3JU,L18,3JU,29,14,15,11
L18 3JX,L18,3JX,15,6,9,5
L18 3JY,L18,3JY,12,5,7,9
L18 3JZ,L18,3JZ,41,27,14,29
L18 3LA,L18,3LA,8,4,4,4
L18 3LB,L18,3LB,50,26,24,38
L18 3LD,L18,3LD,82,40,42,54
L18 3LF,L18,3LF,62,24,38,36
L18 3LH,L18,3LH,17,8,9,9
L18 3LJ,L18,3LJ,108,53,55,42
L18 3LL,L18,3LL,36,13,23,19
L18 3LN,L18,3LN,32,18,14,13
L18 3LP,L18,3LP,16,10,6,5
L18 3LQ,L18,3LQ,82,32,50,63
L18 3LT,L18,3LT,175,89,86,65
L18 3LU,L18,3LU,85,45,40,35
L18 3LW,L18,3LW,48,25,23,22
L18 3NF,L18,3NF,19,9,10,6
L18 3NH,L18,3NH,161,72,89,53
L18 3NJ,L18,3NJ,21,12,9,6
L18 3NL,L18,3NL,34,16,18,13
L18 3NN,L18,3NN,27,13,14,8
L18 3NP,L18,3NP,9,4,5,3
L18 3NQ,L18,3NQ,28,13,15,12
L18 3NU,L18,3NU,23,12,11,8
L18 3NW,L18,3NW,15,9,6,4
L18 4PA,L18,4PA,35,17,18,13
L18 4PB,L18,4PB,38,21,17,17
L18 4PD,L18,4PD,29,16,13,12
L18 4PE,L18,4PE,31,16,15,14
L18 4PF,L18,4PF,41,23,18,16
L18 4PG,L18,4PG,67,32,35,27
L18 4PH,L18,4PH,31,17,14,11
L18 4PJ,L18,4PJ,24,14,10,8
L18 4PL,L18,4PL,29,14,15,10
L18 4PN,L18,4PN,48,25,23,18
L18 4PP,L18,4PP,44,21,23,17
L18 4PQ,L18,4PQ,44,22,22,14
L18 4PR,L18,4PR,44,22,22,18
L18 4PS,L18,4PS,46,22,24,17
L18 4PT,L18,4PT,52,24,28,17
L18 4PU,L18,4PU,58,29,29,26
L18 4PW,L18,4PW,49,21,28,18
L18 4PX,L18,4PX,25,14,11,9
L18 4PY,L18,4PY,48,25,23,18
L18 4PZ,L18,4PZ,67,31,36,22
L18 4QA,L18,4QA,19,10,9,6
L18 4QB,L18,4QB,39,16,23,17
L18 4QD,L18,4QD,10,5,5,7
L18 4QE,L18,4QE,56,23,33,24
L18 4QF,L18,4QF,62,30,32,24
L18 4QG,L18,4QG,78,39,39,28
L18 4QH,L18,4QH,28,11,17,12
L18 4QJ,L18,4QJ,29,17,12,13
L18 4QL,L18,4QL,47,21,26,17
L18 4QN,L18,4QN,38,15,23,15
L18 4QP,L18,4QP,53,25,28,18
L18 4QQ,L18,4QQ,63,29,34,23
L18 4QR,L18,4QR,48,22,26,19
L18 4QS,L18,4QS,62,28,34,21
L18 4QT,L18,4QT,48,25,23,19
L18 4QU,L18,4QU,59,28,31,20
L18 4QW,L18,4QW,45,23,22,16
L18 4QX,L18,4QX,43,17,26,19
L18 4QY,L18,4QY,20,11,9,11
L18 4QZ,L18,4QZ,18,8,10,10
L18 4RB,L18,4RB,23,8,15,8
L18 4RD,L18,4RD,15,5,10,9
L18 4RE,L18,4RE,59,29,30,23
L18 4RF,L18,4RF,57,29,28,19
L18 4RG,L18,4RG,48,24,24,18
L18 4RH,L18,4RH,52,25,27,20
L18 4RJ,L18,4RJ,57,29,28,24
L18 4RL,L18,4RL,13,5,8,6
L18 4RN,L18,4RN,76,40,36,32
L18 4RQ,L18,4RQ,58,32,26,23
L18 4RW,L18,4RW,47,21,26,18
L18 5EA,L18,5EA,27,11,16,12
L18 5ED,L18,5ED,69,32,37,36
L18 5EE,L18,5EE,33,17,16,18
L18 5EF,L18,5EF,24,8,16,16
L18 5EG,L18,5EG,46,22,24,21
L18 5EH,L18,5EH,47,21,26,18
L18 5EJ,L18,5EJ,56,28,28,25
L18 5EL,L18,5EL,70,31,39,33
L18 5EN,L18,5EN,71,34,37,38
L18 5EP,L18,5EP,75,36,39,30
L18 5EQ,L18,5EQ,33,22,11,18
L18 5ER,L18,5ER,31,13,18,20
L18 5ET,L18,5ET,50,24,26,21
L18 5EU,L18,5EU,74,38,36,28
L18 5EW,L18,5EW,95,35,60,53
L18 5EX,L18,5EX,77,40,37,29
L18 5EY,L18,5EY,47,12,35,27
L18 5EZ,L18,5EZ,92,47,45,42
L18 5HA,L18,5HA,70,35,35,33
L18 5HB,L18,5HB,16,8,8,6
L18 5HD,L18,5HD,56,25,31,26
L18 5HE,L18,5HE,75,30,45,33
L18 5HF,L18,5HF,67,32,35,25
L18 5HG,L18,5HG,61,28,33,25
L18 5HH,L18,5HH,66,37,29,25
L18 5HJ,L18,5HJ,73,31,42,30
L18 5HL,L18,5HL,88,40,48,34
L18 5HN,L18,5HN,44,16,28,22
L18 5HP,L18,5HP,39,22,17,13
L18 5HQ,L18,5HQ,65,29,36,30
L18 5HR,L18,5HR,77,32,45,32
L18 5HS,L18,5HS,38,22,16,13
L18 5HU,L18,5HU,2,2,0,1
L18 5HW,L18,5HW,70,34,36,28
L18 5HX,L18,5HX,51,25,26,21
L18 5HY,L18,5HY,33,21,12,15
L18 5HZ,L18,5HZ,29,12,17,13
L18 5JA,L18,5JA,41,21,20,16
L18 5JB,L18,5JB,65,27,38,31
L18 5JD,L18,5JD,90,52,38,45
L18 5JE,L18,5JE,99,42,57,45
L18 5JF,L18,5JF,89,46,43,38
L18 5JG,L18,5JG,66,33,33,25
L18 5JH,L18,5JH,9,4,5,6
L18 5JQ,L18,5JQ,76,39,37,28
L18 6HA,L18,6HA,69,31,38,27
L18 6HB,L18,6HB,49,22,27,18
L18 6HD,L18,6HD,43,23,20,15
L18 6HE,L18,6HE,22,12,10,10
L18 6HF,L18,6HF,3,2,1,2
L18 6HG,L18,6HG,11,4,7,5
L18 6HH,L18,6HH,48,22,26,20
L18 6HJ,L18,6HJ,29,13,16,13
L18 6HL,L18,6HL,36,15,21,14
L18 6HN,L18,6HN,31,15,16,11
L18 6HP,L18,6HP,33,17,16,11
L18 6HR,L18,6HR,71,34,37,27
L18 6HS,L18,6HS,28,13,15,10
L18 6HT,L18,6HT,105,51,54,31
L18 6HU,L18,6HU,50,31,19,17
L18 6HW,L18,6HW,70,35,35,24
L18 6HX,L18,6HX,60,26,34,22
L18 6HY,L18,6HY,51,26,25,24
L18 6HZ,L18,6HZ,49,20,29,19
L18 6JA,L18,6JA,48,21,27,18
L18 6JB,L18,6JB,10,2,8,5
L18 6JD,L18,6JD,25,9,16,12
L18 6JF,L18,6JF,6,5,1,5
L18 6JG,L18,6JG,48,22,26,21
L18 6JH,L18,6JH,14,9,5,6
L18 6JJ,L18,6JJ,42,20,22,17
L18 6JL,L18,6JL,43,18,25,13
L18 6JN,L18,6JN,53,25,28,25
L18 6JP,L18,6JP,32,13,19,14
L18 6JQ,L18,6JQ,67,36,31,21
L18 6JR,L18,6JR,81,39,42,30
L18 6JS,L18,6JS,2,1,1,1
L18 6JT,L18,6JT,55,26,29,21
L18 6JU,L18,6JU,61,35,26,23
L18 6JX,L18,6JX,77,28,49,40
L18 6JY,L18,6JY,35,18,17,12
L18 6JZ,L18,6JZ,65,31,34,24
L18 6LB,L18,6LB,26,12,14,12
L18 7HA,L18,7HA,44,19,25,14
L18 7HB,L18,7HB,49,20,29,21
L18 7HD,L18,7HD,73,34,39,28
L18 7HE,L18,7HE,32,15,17,12
L18 7HF,L18,7HF,43,22,21,19
L18 7HG,L18,7HG,43,25,18,17
L18 7HH,L18,7HH,25,13,12,7
L18 7HJ,L18,7HJ,50,25,25,18
L18 7HL,L18,7HL,36,19,17,12
L18 7HN,L18,7HN,44,23,21,18
L18 7HP,L18,7HP,42,20,22,12
L18 7HQ,L18,7HQ,97,50,47,33
L18 7HS,L18,7HS,76,39,37,27
L18 7HT,L18,7HT,44,22,22,18
L18 7HU,L18,7HU,28,16,12,12
L18 7HW,L18,7HW,43,20,23,30
L18 7HX,L18,7HX,33,18,15,13
L18 7HY,L18,7HY,31,18,13,14
L18 7HZ,L18,7HZ,77,39,38,27
L18 7JA,L18,7JA,60,32,28,25
L18 7JB,L18,7JB,35,18,17,16
L18 7JD,L18,7JD,92,46,46,46
L18 7JE,L18,7JE,67,30,37,30
L18 7JF,L18,7JF,80,37,43,40
L18 7JG,L18,7JG,78,41,37,35
L18 7JH,L18,7JH,94,45,49,36
L18 7JJ,L18,7JJ,94,47,47,37
L18 7JL,L18,7JL,25,10,15,10
L18 7JN,L18,7JN,97,48,49,34
L18 7JP,L18,7JP,24,11,13,10
L18 7JQ,L18,7JQ,90,41,49,37
L18 7JR,L18,7JR,48,26,22,15
L18 7JS,L18,7JS,60,25,35,22
L18 7JT,L18,7JT,57,33,24,27
L18 7JU,L18,7JU,49,24,25,18
L18 7JW,L18,7JW,132,60,72,46
L18 7JX,L18,7JX,35,18,17,14
L18 7JY,L18,7JY,41,23,18,20
L18 7JZ,L18,7JZ,51,23,28,18
L18 7LA,L18,7LA,30,15,15,15
L18 7LB,L18,7LB,71,37,34,23
L18 7LD,L18,7LD,67,36,31,24
L18 7LE,L18,7LE,52,28,24,46
L18 7LF,L18,7LF,26,11,15,17
L18 8AD,L18,8AD,32,20,12,18
L18 8AG,L18,8AG,1,1,0,1
L18 8AH,L18,8AH,52,28,24,24
L18 8AJ,L18,8AJ,69,36,33,37
L18 8AL,L18,8AL,111,66,45,50
L18 8AP,L18,8AP,7,2,5,4
L18 8AR,L18,8AR,99,47,52,50
L18 8AS,L18,8AS,12,5,7,7
L18 8AT,L18,8AT,17,11,6,4
L18 8AU,L18,8AU,28,16,12,16
L18 8AW,L18,8AW,50,18,32,21
L18 8AY,L18,8AY,47,25,22,26
L18 8AZ,L18,8AZ,18,9,9,7
L18 8BA,L18,8BA,22,12,10,14
L18 8BD,L18,8BD,10,6,4,3
L18 8BH,L18,8BH,671,347,324,646
L18 8BJ,L18,8BJ,49,19,30,15
L18 8BL,L18,8BL,70,32,38,27
L18 8BN,L18,8BN,38,2,36,0
L18 8BP,L18,8BP,66,26,40,15
L18 8BR,L18,8BR,58,14,44,0
L18 8BT,L18,8BT,30,15,15,20
L18 8BU,L18,8BU,3,0,3,0
L18 8BX,L18,8BX,10,6,4,4
L18 8BY,L18,8BY,111,42,69,22
L18 8BZ,L18,8BZ,77,34,43,12
L18 8DB,L18,8DB,13,5,8,4
L18 8DF,L18,8DF,205,79,126,3
L18 8DG,L18,8DG,154,90,64,9
L18 8DJ,L18,8DJ,40,18,22,31
L18 8DN,L18,8DN,241,120,121,5
L18 8DP,L18,8DP,187,69,118,2
L18 8DQ,L18,8DQ,230,114,116,0
L18 8DR,L18,8DR,24,15,9,15
L18 8DS,L18,8DS,81,36,45,56
L18 8DW,L18,8DW,174,94,80,0
L18 8DZ,L18,8DZ,25,12,13,10
L18 8EH,L18,8EH,10,6,4,6
L18 8EU,L18,8EU,39,19,20,25
L18 8FB,L18,8FB,87,43,44,54
L18 8FD,L18,8FD,24,11,13,16
L18 8FE,L18,8FE,73,40,33,35
L18 9RA,L18,9RA,68,35,33,41
L18 9SA,L18,9SA,68,36,32,26
L18 9SB,L18,9SB,74,38,36,30
L18 9SD,L18,9SD,90,40,50,32
L18 9SE,L18,9SE,54,26,28,19
L18 9SF,L18,9SF,39,15,24,21
L18 9SG,L18,9SG,37,16,21,16
L18 9SH,L18,9SH,80,36,44,32
L18 9SJ,L18,9SJ,82,40,42,29
L18 9SL,L18,9SL,58,27,31,22
L18 9SN,L18,9SN,79,44,35,26
L18 9SP,L18,9SP,58,28,30,19
L18 9SQ,L18,9SQ,107,46,61,45
L18 9SR,L18,9SR,32,15,17,14
L18 9SS,L18,9SS,20,10,10,7
L18 9ST,L18,9ST,77,37,40,33
L18 9SU,L18,9SU,10,4,6,5
L18 9SW,L18,9SW,70,35,35,28
L18 9SX,L18,9SX,41,25,16,17
L18 9SY,L18,9SY,32,18,14,9
L18 9SZ,L18,9SZ,8,6,2,5
L18 9TA,L18,9TA,53,26,27,24
L18 9TB,L18,9TB,95,51,44,50
L18 9TD,L18,9TD,57,28,29,19
L18 9TE,L18,9TE,62,31,31,23
L18 9TF,L18,9TF,43,22,21,21
L18 9TG,L18,9TG,34,15,19,18
L18 9TH,L18,9TH,79,46,33,25
L18 9TL,L18,9TL,39,22,17,20
L18 9TN,L18,9TN,48,24,24,29
L18 9TP,L18,9TP,68,33,35,41
L18 9TQ,L18,9TQ,75,30,45,35
L18 9TR,L18,9TR,23,14,9,18
L18 9TS,L18,9TS,36,20,16,34
L18 9TT,L18,9TT,48,25,23,31
L18 9TU,L18,9TU,11,6,5,5
L18 9TW,L18,9TW,54,28,26,27
L18 9TX,L18,9TX,34,13,21,18
L18 9TY,L18,9TY,48,30,18,28
L18 9TZ,L18,9TZ,31,19,12,16
L18 9UA,L18,9UA,35,24,11,26
L18 9UB,L18,9UB,52,27,25,15
L18 9UD,L18,9UD,47,23,24,13
L18 9UE,L18,9UE,59,28,31,25
L18 9UF,L18,9UF,53,28,25,21
L18 9UG,L18,9UG,59,26,33,22
L18 9UH,L18,9UH,34,15,19,19
L18 9UJ,L18,9UJ,25,16,9,12
L18 9UL,L18,9UL,33,18,15,12
L18 9UN,L18,9UN,78,32,46,25
L18 9UP,L18,9UP,72,40,32,27
L18 9UQ,L18,9UQ,59,30,29,23
L18 9UR,L18,9UR,94,43,51,36
L18 9US,L18,9US,29,12,17,15
L18 9UT,L18,9UT,27,15,12,13
L18 9UU,L18,9UU,16,7,9,9
L18 9UW,L18,9UW,52,27,25,20
L18 9UY,L18,9UY,35,17,18,22
L18 9UZ,L18,9UZ,40,20,20,23
L18 9XA,L18,9XA,8,1,7,3
L18 9XB,L18,9XB,28,17,11,23
L18 9XN,L18,9XN,58,30,28,23
L18 9XP,L18,9XP,215,96,119,81
L18 9XT,L18,9XT,75,45,30,29
L18 9YE,L18,9YE,29,13,16,13
L19 0JA,L19,0JA,56,25,31,46
L19 0JZ,L19,0JZ,38,21,17,26
L19 0LA,L19,0LA,29,15,14,12
L19 0LB,L19,0LB,29,21,8,19
L19 0LD,L19,0LD,105,61,44,45
L19 0LH,L19,0LH,17,9,8,8
L19 0LJ,L19,0LJ,29,19,10,16
L19 0LL,L19,0LL,16,9,7,10
L19 0LN,L19,0LN,47,26,21,25
L19 0LP,L19,0LP,41,21,20,21
L19 0LR,L19,0LR,24,10,14,12
L19 0LS,L19,0LS,60,32,28,30
L19 0LT,L19,0LT,46,25,21,25
L19 0LU,L19,0LU,38,26,12,34
L19 0LW,L19,0LW,63,43,20,41
L19 0LX,L19,0LX,84,44,40,34
L19 0LY,L19,0LY,38,25,13,14
L19 0LZ,L19,0LZ,4,2,2,1
L19 0NA,L19,0NA,32,16,16,12
L19 0NB,L19,0NB,101,45,56,41
L19 0ND,L19,0ND,27,15,12,12
L19 0NE,L19,0NE,33,18,15,22
L19 0NH,L19,0NH,7,1,6,3
L19 0NJ,L19,0NJ,30,16,14,23
L19 0NL,L19,0NL,96,44,52,41
L19 0NN,L19,0NN,51,27,24,23
L19 0NP,L19,0NP,99,47,52,41
L19 0NQ,L19,0NQ,65,31,34,27
L19 0NR,L19,0NR,37,15,22,15
L19 0NS,L19,0NS,62,25,37,24
L19 0NT,L19,0NT,20,10,10,10
L19 0NU,L19,0NU,3,3,0,1
L19 0NW,L19,0NW,14,9,5,6
L19 0NX,L19,0NX,6,2,4,4
L19 0NY,L19,0NY,22,17,5,11
L19 0PA,L19,0PA,30,15,15,18
L19 0PB,L19,0PB,74,36,38,37
L19 0PD,L19,0PD,61,31,30,23
L19 0PE,L19,0PE,30,17,13,11
L19 0PF,L19,0PF,43,17,26,20
L19 0PG,L19,0PG,56,32,24,28
L19 0PH,L19,0PH,81,42,39,27
L19 0PJ,L19,0PJ,59,33,26,24
L19 0PL,L19,0PL,10,4,6,4
L19 0PN,L19,0PN,26,12,14,12
L19 0PP,L19,0PP,12,6,6,5
L19 0PQ,L19,0PQ,22,12,10,13
L19 0PR,L19,0PR,19,8,11,8
L19 0PS,L19,0PS,41,18,23,15
L19 0PT,L19,0PT,44,23,21,15
L19 0PU,L19,0PU,28,15,13,12
L19 0PW,L19,0PW,41,18,23,18
L19 0PX,L19,0PX,28,14,14,13
L19 0QG,L19,0QG,38,17,21,35
L19 0QH,L19,0QH,13,7,6,10
L19 0QL,L19,0QL,45,12,33,0
L19 0QN,L19,0QN,31,16,15,19
L19 1QA,L19,1QA,29,9,20,13
L19 1QB,L19,1QB,89,40,49,37
L19 1QD,L19,1QD,8,7,1,5
L19 1QE,L19,1QE,77,41,36,31
L19 1QF,L19,1QF,52,24,28,24
L19 1QG,L19,1QG,97,42,55,47
L19 1QH,L19,1QH,68,30,38,33
L19 1QJ,L19,1QJ,59,27,32,25
L19 1QL,L19,1QL,92,44,48,37
L19 1QN,L19,1QN,62,28,34,28
L19 1QP,L19,1QP,45,23,22,24
L19 1QQ,L19,1QQ,132,66,66,53
L19 1QR,L19,1QR,70,33,37,44
L19 1QS,L19,1QS,69,32,37,40
L19 1QT,L19,1QT,47,19,28,22
L19 1QU,L19,1QU,14,7,7,10
L19 1QW,L19,1QW,32,20,12,13
L19 1QY,L19,1QY,89,41,48,36
L19 1QZ,L19,1QZ,116,57,59,51
L19 1RA,L19,1RA,5,2,3,4
L19 1RB,L19,1RB,6,3,3,4
L19 1RE,L19,1RE,63,31,32,35
L19 1RF,L19,1RF,106,53,53,43
L19 1RG,L19,1RG,40,17,23,21
L19 1RJ,L19,1RJ,83,41,42,34
L19 1RL,L19,1RL,60,30,30,22
L19 1RN,L19,1RN,46,26,20,24
L19 1RP,L19,1RP,92,51,41,44
L19 1RQ,L19,1RQ,104,48,56,38
L19 1RR,L19,1RR,77,43,34,38
L19 1RS,L19,1RS,34,16,18,17
L19 1RT,L19,1RT,87,38,49,53
L19 1RU,L19,1RU,19,10,9,11
L19 1RX,L19,1RX,38,22,16,19
L19 1RY,L19,1RY,106,53,53,40
L19 1RZ,L19,1RZ,73,29,44,34
L19 1SP,L19,1SP,18,9,9,12
L19 2AB,L19,2AB,30,15,15,21
L19 2HA,L19,2HA,33,15,18,10
L19 2HB,L19,2HB,68,33,35,25
L19 2HD,L19,2HD,49,23,26,22
L19 2HE,L19,2HE,68,39,29,33
L19 2HF,L19,2HF,62,35,27,21
L19 2HG,L19,2HG,38,21,17,14
L19 2HJ,L19,2HJ,22,10,12,9
L19 2HL,L19,2HL,25,11,14,9
L19 2HP,L19,2HP,32,16,16,14
L19 2HQ,L19,2HQ,65,35,30,27
L19 2HR,L19,2HR,12,7,5,6
L19 2HS,L19,2HS,38,21,17,17
L19 2HW,L19,2HW,57,26,31,23
L19 2JD,L19,2JD,29,19,10,16
L19 2JG,L19,2JG,35,17,18,17
L19 2JJ,L19,2JJ,25,15,10,19
L19 2JP,L19,2JP,115,49,66,66
L19 2JT,L19,2JT,63,35,28,45
L19 2JX,L19,2JX,3,2,1,2
L19 2LA,L19,2LA,12,8,4,6
L19 2LB,L19,2LB,40,22,18,19
L19 2LD,L19,2LD,14,4,10,8
L19 2LE,L19,2LE,39,17,22,20
L19 2LF,L19,2LF,11,4,7,5
L19 2LG,L19,2LG,59,26,33,27
L19 2LH,L19,2LH,55,23,32,30
L19 2LJ,L19,2LJ,110,58,52,54
L19 2LL,L19,2LL,13,7,6,6
L19 2LQ,L19,2LQ,15,5,10,8
L19 2LS,L19,2LS,21,13,8,15
L19 2LT,L19,2LT,54,23,31,25
L19 2LW,L19,2LW,39,24,15,20
L19 2LX,L19,2LX,83,45,38,37
L19 2LY,L19,2LY,80,37,43,40
L19 2NA,L19,2NA,101,50,51,46
L19 2NB,L19,2NB,123,55,68,52
L19 2ND,L19,2ND,109,46,63,50
L19 2NE,L19,2NE,94,45,49,35
L19 2NJ,L19,2NJ,8,6,2,7
L19 2NL,L19,2NL,9,6,3,6
L19 2NP,L19,2NP,78,47,31,52
L19 2NR,L19,2NR,4,4,0,4
L19 2NZ,L19,2NZ,23,13,10,12
L19 2PA,L19,2PA,1,0,1,1
L19 2PQ,L19,2PQ,42,23,19,19
L19 2PR,L19,2PR,42,19,23,23
L19 2PS,L19,2PS,35,16,19,21
L19 2PT,L19,2PT,21,12,9,11
L19 2PU,L19,2PU,131,60,71,54
L19 2QG,L19,2QG,31,12,19,10
L19 2QY,L19,2QY,128,65,63,79
L19 2QZ,L19,2QZ,124,64,60,55
L19 2RL,L19,2RL,43,19,24,15
L19 2RP,L19,2RP,68,40,28,29
L19 2RR,L19,2RR,121,64,57,44
L19 2RS,L19,2RS,110,49,61,48
L19 2RT,L19,2RT,58,30,28,24
L19 2RU,L19,2RU,78,39,39,35
L19 2RX,L19,2RX,5,5,0,5
L19 3PA,L19,3PA,49,25,24,18
L19 3PD,L19,3PD,85,44,41,30
L19 3PE,L19,3PE,60,31,29,27
L19 3PF,L19,3PF,36,20,16,16
L19 3PG,L19,3PG,68,41,27,32
L19 3PH,L19,3PH,70,33,37,30
L19 3PJ,L19,3PJ,12,5,7,6
L19 3PL,L19,3PL,88,42,46,36
L19 3PN,L19,3PN,52,24,28,18
L19 3PP,L19,3PP,39,16,23,16
L19 3PQ,L19,3PQ,77,39,38,28
L19 3PR,L19,3PR,28,15,13,10
L19 3PS,L19,3PS,69,35,34,25
L19 3PT,L19,3PT,78,38,40,32
L19 3PU,L19,3PU,105,52,53,36
L19 3PW,L19,3PW,51,27,24,18
L19 3PX,L19,3PX,35,15,20,17
L19 3PY,L19,3PY,54,24,30,21
L19 3PZ,L19,3PZ,44,22,22,15
L19 3QA,L19,3QA,83,42,41,42
L19 3QB,L19,3QB,26,13,13,14
L19 3QD,L19,3QD,45,18,27,23
L19 3QE,L19,3QE,49,24,25,27
L19 3QF,L19,3QF,5,2,3,2
L19 3QG,L19,3QG,17,6,11,10
L19 3QH,L19,3QH,32,11,21,10
L19 3QJ,L19,3QJ,40,15,25,20
L19 3QL,L19,3QL,38,15,23,17
L19 3QP,L19,3QP,7,3,4,2
L19 3QS,L19,3QS,52,23,29,27
L19 3QT,L19,3QT,25,15,10,15
L19 3QU,L19,3QU,92,50,42,35
L19 3QW,L19,3QW,15,11,4,8
L19 3QX,L19,3QX,86,40,46,32
L19 3QY,L19,3QY,69,33,36,30
L19 3QZ,L19,3QZ,65,30,35,30
L19 3RA,L19,3RA,39,17,22,13
L19 3RB,L19,3RB,38,20,18,19
L19 3RD,L19,3RD,77,41,36,30
L19 3RE,L19,3RE,71,37,34,25
L19 3RF,L19,3RF,31,19,12,15
L19 3RG,L19,3RG,22,7,15,13
L19 3RJ,L19,3RJ,46,23,23,23
L19 3RL,L19,3RL,15,10,5,7
L19 3RN,L19,3RN,15,10,5,8
L19 3RS,L19,3RS,28,20,8,17
L19 3RW,L19,3RW,22,11,11,12
L19 3RY,L19,3RY,65,36,29,49
L19 3RZ,L19,3RZ,97,45,52,58
L19 4TA,L19,4TA,33,14,19,13
L19 4TB,L19,4TB,12,6,6,6
L19 4TD,L19,4TD,29,13,16,12
L19 4TE,L19,4TE,48,22,26,21
L19 4TF,L19,4TF,20,11,9,9
L19 4TG,L19,4TG,51,31,20,24
L19 4TH,L19,4TH,51,22,29,24
L19 4TJ,L19,4TJ,27,12,15,15
L19 4TL,L19,4TL,30,13,17,13
L19 4TP,L19,4TP,19,9,10,7
L19 4TQ,L19,4TQ,118,57,61,44
L19 4TR,L19,4TR,82,35,47,34
L19 4TS,L19,4TS,126,68,58,54
L19 4TT,L19,4TT,81,41,40,33
L19 4TU,L19,4TU,95,41,54,43
L19 4TW,L19,4TW,56,34,22,29
L19 4TX,L19,4TX,51,24,27,23
L19 4TY,L19,4TY,58,27,31,27
L19 4TZ,L19,4TZ,155,73,82,59
L19 4UA,L19,4UA,21,9,12,11
L19 4UB,L19,4UB,142,67,75,54
L19 4UD,L19,4UD,100,46,54,41
L19 4UE,L19,4UE,31,11,20,25
L19 4UF,L19,4UF,89,37,52,29
L19 4UG,L19,4UG,69,27,42,32
L19 4UJ,L19,4UJ,25,14,11,18
L19 4UL,L19,4UL,106,51,55,38
L19 4UN,L19,4UN,98,53,45,37
L19 4UP,L19,4UP,69,27,42,24
L19 4UR,L19,4UR,82,40,42,32
L19 4US,L19,4US,45,21,24,26
L19 4UT,L19,4UT,90,39,51,31
L19 4UU,L19,4UU,79,44,35,35
L19 4UW,L19,4UW,82,36,46,33
L19 4UX,L19,4UX,107,46,61,37
L19 4UY,L19,4UY,94,43,51,37
L19 4UZ,L19,4UZ,69,32,37,27
L19 4XA,L19,4XA,91,38,53,34
L19 4XB,L19,4XB,70,36,34,31
L19 4XD,L19,4XD,67,32,35,24
L19 4XE,L19,4XE,94,38,56,38
L19 4XF,L19,4XF,67,31,36,32
L19 4XG,L19,4XG,8,2,6,4
L19 4XH,L19,4XH,55,34,21,39
L19 4XN,L19,4XN,9,5,4,7
L19 4XS,L19,4XS,119,59,60,33
L19 4XT,L19,4XT,9,4,5,3
L19 5NA,L19,5NA,13,6,7,6
L19 5NB,L19,5NB,148,71,77,59
L19 5ND,L19,5ND,64,27,37,28
L19 5NE,L19,5NE,32,17,15,18
L19 5NF,L19,5NF,24,13,11,10
L19 5NG,L19,5NG,55,28,27,14
L19 5NH,L19,5NH,44,19,25,30
L19 5NJ,L19,5NJ,52,23,29,25
L19 5NL,L19,5NL,37,13,24,17
L19 5NN,L19,5NN,114,56,58,42
L19 5NP,L19,5NP,54,25,29,27
L19 5NQ,L19,5NQ,2,1,1,1
L19 5NR,L19,5NR,40,17,23,19
L19 5NS,L19,5NS,26,12,14,11
L19 5NT,L19,5NT,22,13,9,9
L19 5NU,L19,5NU,54,28,26,28
L19 5NW,L19,5NW,94,46,48,39
L19 5NX,L19,5NX,18,15,3,16
L19 5NY,L19,5NY,26,11,15,13
L19 5NZ,L19,5NZ,69,33,36,33
L19 5PA,L19,5PA,26,10,16,14
L19 5PB,L19,5PB,28,11,17,12
L19 5PD,L19,5PD,24,7,17,11
L19 5PE,L19,5PE,97,47,50,47
L19 5PF,L19,5PF,116,55,61,52
L19 5PG,L19,5PG,68,31,37,32
L19 5PH,L19,5PH,130,58,72,62
L19 5PL,L19,5PL,19,10,9,11
L19 5PQ,L19,5PQ,40,21,19,28
L19 6PA,L19,6PA,139,82,57,71
L19 6PD,L19,6PD,19,10,9,6
L19 6PE,L19,6PE,46,27,19,24
L19 6PF,L19,6PF,51,27,24,27
L19 6PG,L19,6PG,41,21,20,16
L19 6PH,L19,6PH,48,24,24,18
L19 6PJ,L19,6PJ,118,63,55,61
L19 6PL,L19,6PL,46,26,20,20
L19 6PN,L19,6PN,92,47,45,33
L19 6PP,L19,6PP,27,23,4,18
L19 6PQ,L19,6PQ,69,34,35,26
L19 6PR,L19,6PR,66,33,33,25
L19 6PS,L19,6PS,65,31,34,26
L19 6PT,L19,6PT,73,38,35,27
L19 6PU,L19,6PU,71,31,40,26
L19 6PW,L19,6PW,126,60,66,53
L19 6PX,L19,6PX,63,34,29,25
L19 6PY,L19,6PY,28,13,15,13
L19 6PZ,L19,6PZ,27,14,13,15
L19 6QA,L19,6QA,78,43,35,33
L19 6QB,L19,6QB,67,31,36,31
L19 6QD,L19,6QD,36,16,20,14
L19 7NA,L19,7NA,90,45,45,29
L19 7NB,L19,7NB,21,9,12,10
L19 7ND,L19,7ND,113,55,58,42
L19 7NE,L19,7NE,102,49,53,36
L19 7NF,L19,7NF,39,18,21,15
L19 7NG,L19,7NG,78,39,39,30
L19 7NH,L19,7NH,25,11,14,10
L19 7NJ,L19,7NJ,32,14,18,16
L19 7NL,L19,7NL,28,15,13,15
L19 7NN,L19,7NN,143,72,71,51
L19 7NQ,L19,7NQ,99,43,56,39
L19 7NR,L19,7NR,71,35,36,30
L19 7NS,L19,7NS,54,26,28,24
L19 7NT,L19,7NT,31,14,17,10
L19 7NU,L19,7NU,111,49,62,44
L19 7NW,L19,7NW,130,70,60,47
L19 7NX,L19,7NX,12,10,2,9
L19 7NY,L19,7NY,9,4,5,4
L19 7PG,L19,7PG,57,25,32,27
L19 8AB,L19,8AB,120,71,49,45
L19 8BQ,L19,8BQ,21,12,9,8
L19 8DA,L19,8DA,77,39,38,25
L19 8DB,L19,8DB,89,44,45,29
L19 8DD,L19,8DD,46,24,22,17
L19 8DE,L19,8DE,19,9,10,8
L19 8EA,L19,8EA,7,5,2,5
L19 8EE,L19,8EE,73,40,33,24
L19 8EH,L19,8EH,70,39,31,38
L19 8EJ,L19,8EJ,57,37,20,28
L19 8EL,L19,8EL,53,30,23,18
L19 8EQ,L19,8EQ,32,15,17,10
L19 8ER,L19,8ER,82,30,52,33
L19 8HG,L19,8HG,21,9,12,10
L19 8HT,L19,8HT,81,37,44,26
L19 8HX,L19,8HX,21,10,11,7
L19 8HZ,L19,8HZ,55,27,28,26
L19 8JD,L19,8JD,1,1,0,1
L19 8JL,L19,8JL,97,45,52,47
L19 8JN,L19,8JN,87,33,54,35
L19 8JP,L19,8JP,95,41,54,41
L19 8JR,L19,8JR,113,54,59,50
L19 8JS,L19,8JS,101,44,57,44
L19 8JT,L19,8JT,123,54,69,47
L19 8JU,L19,8JU,42,23,19,21
L19 8JW,L19,8JW,60,35,25,33
L19 8JX,L19,8JX,10,7,3,8
L19 8JZ,L19,8JZ,13,6,7,7
L19 8LA,L19,8LA,72,38,34,36
L19 8LB,L19,8LB,79,37,42,39
L19 8LD,L19,8LD,125,58,67,58
L19 8LE,L19,8LE,98,45,53,51
L19 8LF,L19,8LF,145,68,77,61
L19 8LG,L19,8LG,85,39,46,36
L19 8LH,L19,8LH,85,36,49,39
L19 8LJ,L19,8LJ,81,40,41,31
L19 8LL,L19,8LL,84,34,50,41
L19 8LN,L19,8LN,12,5,7,8
L19 8LP,L19,8LP,34,16,18,26
L19 8LQ,L19,8LQ,155,73,82,62
L19 8LR,L19,8LR,21,6,15,17
L19 8LU,L19,8LU,43,25,18,17
L19 8LW,L19,8LW,20,9,11,8
L19 8LX,L19,8LX,72,40,32,44
L19 8LY,L19,8LY,46,32,14,43
L19 8NG,L19,8NG,8,4,4,3
L19 8NH,L19,8NH,19,5,14,11
L19 8NS,L19,8NS,18,8,10,8
L19 8NT,L19,8NT,24,15,9,9
L19 8NU,L19,8NU,27,15,12,11
L19 9AD,L19,9AD,75,34,41,39
L19 9AE,L19,9AE,65,26,39,25
L19 9AF,L19,9AF,51,25,26,26
L19 9AG,L19,9AG,32,16,16,10
L19 9AH,L19,9AH,63,31,32,34
L19 9AJ,L19,9AJ,76,40,36,55
L19 9AL,L19,9AL,107,54,53,40
L19 9AN,L19,9AN,31,17,14,10
L19 9AP,L19,9AP,24,10,14,7
L19 9AQ,L19,9AQ,53,25,28,20
L19 9AR,L19,9AR,30,14,16,16
L19 9AS,L19,9AS,19,9,10,7
L19 9AT,L19,9AT,38,18,20,18
L19 9AU,L19,9AU,91,39,52,37
L19 9AW,L19,9AW,32,18,14,20
L19 9AX,L19,9AX,64,36,28,17
L19 9AY,L19,9AY,116,50,66,39
L19 9AZ,L19,9AZ,57,25,32,20
L19 9BA,L19,9BA,9,9,0,1
L19 9BB,L19,9BB,42,24,18,18
L19 9BD,L19,9BD,25,12,13,11
L19 9BE,L19,9BE,41,19,22,16
L19 9BG,L19,9BG,18,8,10,10
L19 9BH,L19,9BH,38,18,20,15
L19 9BJ,L19,9BJ,80,42,38,32
L19 9BL,L19,9BL,71,32,39,42
L19 9BN,L19,9BN,36,20,16,15
L19 9BP,L19,9BP,48,25,23,17
L19 9BQ,L19,9BQ,88,43,45,33
L19 9BR,L19,9BR,74,35,39,27
L19 9BS,L19,9BS,59,30,29,20
L19 9BU,L19,9BU,71,33,38,22
L19 9BW,L19,9BW,38,19,19,13
L19 9BX,L19,9BX,51,23,28,18
L19 9BY,L19,9BY,80,41,39,33
L19 9BZ,L19,9BZ,85,45,40,32
L19 9DA,L19,9DA,45,23,22,16
L19 9DB,L19,9DB,106,53,53,39
L19 9DD,L19,9DD,26,12,14,9
L19 9DE,L19,9DE,11,3,8,2
L19 9DF,L19,9DF,63,27,36,27
L19 9DG,L19,9DG,18,11,7,7
L19 9DH,L19,9DH,92,44,48,34
L19 9DJ,L19,9DJ,65,30,35,18
L19 9DL,L19,9DL,37,17,20,14
L19 9DN,L19,9DN,29,4,25,3
L19 9DP,L19,9DP,90,44,46,41
L19 9DQ,L19,9DQ,22,12,10,9
L19 9DR,L19,9DR,83,38,45,34
L19 9DS,L19,9DS,79,37,42,29
L19 9DT,L19,9DT,47,24,23,17
L19 9DU,L19,9DU,72,33,39,32
L19 9DW,L19,9DW,14,5,9,9
L19 9DX,L19,9DX,9,5,4,4
L19 9DY,L19,9DY,30,11,19,15
L19 9DZ,L19,9DZ,31,15,16,16
L19 9EA,L19,9EA,52,28,24,19
L19 9EB,L19,9EB,26,9,17,12
L19 9ED,L19,9ED,10,5,5,5
L19 9EE,L19,9EE,36,16,20,19
L19 9EF,L19,9EF,62,32,30,22
L19 9EQ,L19,9EQ,54,24,30,19
L19 9ES,L19,9ES,55,12,43,14
L19 9EY,L19,9EY,7,3,4,4
L19 9HA,L19,9HA,19,11,8,8
L19 9HG,L19,9HG,58,28,30,20
L2  0NE,L2,0NE,1,1,0,1
L2  0NZ,L2,0NZ,42,23,19,28
L2  0PQ,L2,0PQ,9,2,7,4
L2  0XJ,L2,0XJ,64,41,23,44
L2  2AE,L2,2AE,10,8,2,8
L2  2AW,L2,2AW,20,13,7,14
L2  2BP,L2,2BP,4,4,0,2
L2  2DQ,L2,2DQ,86,57,29,59
L2  2DT,L2,2DT,2,2,0,2
L2  2DX,L2,2DX,61,30,31,41
L2  2DY,L2,2DY,13,8,5,8
L2  2EN,L2,2EN,35,24,11,24
L2  2EZ,L2,2EZ,21,18,3,16
L2  2JH,L2,2JH,33,22,11,21
L2  2SR,L2,2SR,40,27,13,24
L2  2SX,L2,2SX,63,40,23,43
L2  3PH,L2,3PH,31,20,11,19
L2  3PQ,L2,3PQ,2,2,0,2
L2  4SA,L2,4SA,2,2,0,2
L2  4SX,L2,4SX,2,2,0,1
L2  4TE,L2,4TE,25,11,14,16
L2  4TR,L2,4TR,8,6,2,4
L2  4TX,L2,4TX,1,0,1,1
L2  5BA,L2,5BA,47,25,22,30
L2  5BB,L2,5BB,31,22,9,24
L2  5QA,L2,5QA,41,27,14,26
L2  5QS,L2,5QS,24,16,8,19
L2  5QU,L2,5QU,5,2,3,2
L2  5RH,L2,5RH,6,4,2,4
L2  5SX,L2,5SX,48,25,23,33
L2  6PB,L2,6PB,1,1,0,1
L2  6PS,L2,6PS,8,5,3,6
L2  6PT,L2,6PT,22,14,8,15
L2  6PY,L2,6PY,12,12,0,9
L2  6RE,L2,6RE,3,2,1,1
L2  7LQ,L2,7LQ,14,8,6,10
L2  7NB,L2,7NB,6,4,2,4
L2  7NE,L2,7NE,48,26,22,28
L2  7PQ,L2,7PQ,1,0,1,1
L2  8TZ,L2,8TZ,4,4,0,4
L2  9RU,L2,9RU,39,20,19,21
L20 0AD,L20,0AD,45,19,26,19
L20 0AE,L20,0AE,43,25,18,19
L20 0AF,L20,0AF,47,23,24,21
L20 0AG,L20,0AG,39,21,18,18
L20 0AH,L20,0AH,49,23,26,16
L20 0AJ,L20,0AJ,8,4,4,5
L20 0AL,L20,0AL,65,35,30,30
L20 0AN,L20,0AN,46,18,28,17
L20 0AP,L20,0AP,56,21,35,23
L20 0AQ,L20,0AQ,30,12,18,14
L20 0AR,L20,0AR,59,29,30,24
L20 0AS,L20,0AS,68,24,44,28
L20 0AT,L20,0AT,68,33,35,24
L20 0AU,L20,0AU,51,23,28,20
L20 0AW,L20,0AW,72,36,36,25
L20 0AX,L20,0AX,19,8,11,5
L20 0AY,L20,0AY,90,47,43,34
L20 0AZ,L20,0AZ,84,36,48,27
L20 0BA,L20,0BA,33,15,18,12
L20 0BB,L20,0BB,45,21,24,13
L20 0BD,L20,0BD,52,25,27,19
L20 0BE,L20,0BE,66,36,30,26
L20 0BG,L20,0BG,49,21,28,20
L20 0BH,L20,0BH,80,42,38,32
L20 0BJ,L20,0BJ,53,27,26,19
L20 0BL,L20,0BL,52,28,24,18
L20 0BN,L20,0BN,60,27,33,25
L20 0BP,L20,0BP,15,7,8,15
L20 0BQ,L20,0BQ,36,19,17,16
L20 0BR,L20,0BR,35,16,19,16
L20 0BS,L20,0BS,6,2,4,4
L20 0BT,L20,0BT,79,39,40,22
L20 0BU,L20,0BU,34,15,19,13
L20 0BW,L20,0BW,88,45,43,40
L20 0BX,L20,0BX,73,36,37,28
L20 0BY,L20,0BY,73,34,39,32
L20 0BZ,L20,0BZ,78,37,41,36
L20 0DA,L20,0DA,20,10,10,6
L20 0DB,L20,0DB,40,21,19,15
L20 0DD,L20,0DD,45,20,25,17
L20 0DE,L20,0DE,29,14,15,11
L20 0DF,L20,0DF,43,19,24,16
L20 0DG,L20,0DG,37,14,23,18
L20 0DH,L20,0DH,64,27,37,22
L20 0DJ,L20,0DJ,80,34,46,32
L20 0DL,L20,0DL,69,36,33,26
L20 0DN,L20,0DN,61,28,33,25
L20 0DP,L20,0DP,81,38,43,27
L20 0DQ,L20,0DQ,33,17,16,11
L20 0DR,L20,0DR,81,34,47,30
L20 0DS,L20,0DS,19,8,11,6
L20 0DT,L20,0DT,63,27,36,26
L20 0DU,L20,0DU,19,9,10,10
L20 0DW,L20,0DW,75,38,37,26
L20 0DY,L20,0DY,53,24,29,17
L20 0DZ,L20,0DZ,36,15,21,16
L20 0EA,L20,0EA,48,26,22,20
L20 0ED,L20,0ED,35,16,19,14
L20 0EE,L20,0EE,84,40,44,31
L20 0EF,L20,0EF,65,31,34,24
L20 0EQ,L20,0EQ,35,12,23,30
L20 1EZ,L20,1EZ,4,3,1,3
L20 2AA,L20,2AA,21,13,8,10
L20 2AB,L20,2AB,11,7,4,9
L20 2AD,L20,2AD,15,7,8,11
L20 2AT,L20,2AT,34,15,19,17
L20 2BG,L20,2BG,34,21,13,27
L20 2BN,L20,2BN,54,24,30,25
L20 2BX,L20,2BX,13,9,4,8
L20 2BY,L20,2BY,26,12,14,14
L20 2BZ,L20,2BZ,53,21,32,26
L20 2DA,L20,2DA,4,4,0,1
L20 2DE,L20,2DE,80,37,43,28
L20 2DF,L20,2DF,94,49,45,25
L20 2DG,L20,2DG,18,9,9,8
L20 2DH,L20,2DH,23,9,14,16
L20 2DJ,L20,2DJ,25,12,13,15
L20 2DL,L20,2DL,68,37,31,22
L20 2DQ,L20,2DQ,9,5,4,5
L20 2DR,L20,2DR,122,69,53,35
L20 2DS,L20,2DS,52,28,24,21
L20 2DT,L20,2DT,107,48,59,37
L20 2DW,L20,2DW,15,9,6,6
L20 2EA,L20,2EA,20,7,13,10
L20 2EB,L20,2EB,5,3,2,2
L20 2ED,L20,2ED,68,33,35,28
L20 2EE,L20,2EE,29,18,11,16
L20 2EF,L20,2EF,18,8,10,9
L20 2EG,L20,2EG,84,42,42,39
L20 2EH,L20,2EH,86,43,43,40
L20 2EJ,L20,2EJ,69,32,37,26
L20 2EL,L20,2EL,95,49,46,41
L20 2EN,L20,2EN,51,24,27,27
L20 2EP,L20,2EP,50,23,27,24
L20 2EQ,L20,2EQ,52,27,25,27
L20 2ER,L20,2ER,72,27,45,35
L20 2ES,L20,2ES,54,28,26,25
L20 2ET,L20,2ET,105,47,58,49
L20 2EU,L20,2EU,80,38,42,33
L20 2EW,L20,2EW,95,43,52,37
L20 2EX,L20,2EX,61,31,30,24
L20 2EY,L20,2EY,84,38,46,36
L20 2HA,L20,2HA,108,64,44,50
L20 2HL,L20,2HL,77,37,40,40
L20 2HR,L20,2HR,43,19,24,22
L20 2HU,L20,2HU,93,44,49,46
L20 2HW,L20,2HW,88,44,44,39
L20 2HX,L20,2HX,76,39,37,37
L20 2HZ,L20,2HZ,8,3,5,6
L20 2JA,L20,2JA,84,39,45,35
L20 2JL,L20,2JL,21,11,10,16
L20 2QA,L20,2QA,19,10,9,11
L20 2QB,L20,2QB,19,7,12,9
L20 3AB,L20,3AB,65,38,27,32
L20 3AD,L20,3AD,28,15,13,12
L20 3AN,L20,3AN,22,13,9,19
L20 3AP,L20,3AP,27,12,15,15
L20 3AR,L20,3AR,21,12,9,3
L20 3AS,L20,3AS,42,25,17,19
L20 3AU,L20,3AU,12,5,7,6
L20 3AW,L20,3AW,20,9,11,8
L20 3AZ,L20,3AZ,21,10,11,14
L20 3BB,L20,3BB,34,22,12,13
L20 3BG,L20,3BG,74,35,39,33
L20 3BJ,L20,3BJ,20,14,6,0
L20 3BN,L20,3BN,35,23,12,14
L20 3BR,L20,3BR,11,6,5,6
L20 3BU,L20,3BU,32,13,19,14
L20 3BX,L20,3BX,68,35,33,29
L20 3BY,L20,3BY,23,15,8,8
L20 3BZ,L20,3BZ,3,3,0,2
L20 3DB,L20,3DB,4,2,2,2
L20 3DE,L20,3DE,25,15,10,11
L20 3DF,L20,3DF,19,11,8,8
L20 3DG,L20,3DG,7,3,4,6
L20 3DQ,L20,3DQ,42,21,21,18
L20 3DY,L20,3DY,4,4,0,4
L20 3EJ,L20,3EJ,31,16,15,15
L20 3ER,L20,3ER,5,2,3,2
L20 3ET,L20,3ET,8,5,3,4
L20 3EY,L20,3EY,36,15,21,17
L20 3HA,L20,3HA,46,22,24,19
L20 3HE,L20,3HE,28,12,16,18
L20 3HF,L20,3HF,61,29,32,28
L20 3HG,L20,3HG,48,18,30,20
L20 3HH,L20,3HH,25,10,15,13
L20 3HJ,L20,3HJ,32,20,12,11
L20 3HN,L20,3HN,17,9,8,9
L20 3HQ,L20,3HQ,45,23,22,24
L20 3HZ,L20,3HZ,7,3,4,4
L20 3JB,L20,3JB,10,4,6,7
L20 3JY,L20,3JY,47,22,25,20
L20 3LL,L20,3LL,26,15,11,22
L20 3NP,L20,3NP,24,9,15,10
L20 3NR,L20,3NR,16,11,5,12
L20 3NS,L20,3NS,16,7,9,12
L20 3NT,L20,3NT,33,18,15,14
L20 3NU,L20,3NU,30,12,18,15
L20 3NX,L20,3NX,83,44,39,33
L20 3NY,L20,3NY,57,25,32,19
L20 3NZ,L20,3NZ,41,21,20,23
L20 3PA,L20,3PA,41,21,20,20
L20 3PJ,L20,3PJ,51,27,24,48
L20 3PL,L20,3PL,19,11,8,17
L20 3QJ,L20,3QJ,42,24,18,32
L20 3QL,L20,3QL,43,25,18,37
L20 3QN,L20,3QN,40,19,21,33
L20 3RL,L20,3RL,47,15,32,36
L20 3SE,L20,3SE,61,26,35,51
L20 3SP,L20,3SP,5,3,2,3
L20 3TQ,L20,3TQ,41,16,25,35
L20 3TX,L20,3TX,20,12,8,8
L20 3TY,L20,3TY,23,10,13,16
L20 3TZ,L20,3TZ,45,21,24,19
L20 3UA,L20,3UA,10,4,6,3
L20 3UB,L20,3UB,32,10,22,10
L20 3UG,L20,3UG,144,60,84,49
L20 3UH,L20,3UH,46,22,24,15
L20 3UQ,L20,3UQ,75,33,42,23
L20 4AP,L20,4AP,42,23,19,9
L20 4AU,L20,4AU,23,15,8,14
L20 4AX,L20,4AX,33,12,21,14
L20 4AY,L20,4AY,17,9,8,9
L20 4AZ,L20,4AZ,33,22,11,22
L20 4BB,L20,4BB,10,5,5,2
L20 4BG,L20,4BG,35,18,17,13
L20 4BL,L20,4BL,48,24,24,23
L20 4BP,L20,4BP,32,17,15,23
L20 4BU,L20,4BU,14,6,8,8
L20 4DB,L20,4DB,38,19,19,12
L20 4DF,L20,4DF,18,10,8,8
L20 4DG,L20,4DG,39,20,19,15
L20 4DH,L20,4DH,54,39,15,47
L20 4DJ,L20,4DJ,52,40,12,41
L20 4DL,L20,4DL,65,30,35,21
L20 4DS,L20,4DS,23,12,11,11
L20 4DT,L20,4DT,13,7,6,4
L20 4EF,L20,4EF,24,11,13,7
L20 4EH,L20,4EH,29,13,16,14
L20 4EJ,L20,4EJ,87,46,41,31
L20 4EL,L20,4EL,44,24,20,19
L20 4ET,L20,4ET,7,3,4,3
L20 4EU,L20,4EU,34,18,16,15
L20 4EX,L20,4EX,78,36,42,36
L20 4EY,L20,4EY,34,13,21,18
L20 4FB,L20,4FB,8,4,4,6
L20 4FD,L20,4FD,77,32,45,23
L20 4FE,L20,4FE,21,11,10,16
L20 4HA,L20,4HA,45,30,15,36
L20 4HB,L20,4HB,33,10,23,16
L20 4HH,L20,4HH,23,11,12,9
L20 4HU,L20,4HU,9,6,3,5
L20 4JA,L20,4JA,19,13,6,8
L20 4JB,L20,4JB,15,9,6,9
L20 4JG,L20,4JG,20,11,9,14
L20 4JJ,L20,4JJ,22,7,15,12
L20 4JL,L20,4JL,74,32,42,37
L20 4JN,L20,4JN,54,34,20,35
L20 4JP,L20,4JP,24,11,13,14
L20 4JR,L20,4JR,56,32,24,31
L20 4JS,L20,4JS,50,29,21,26
L20 4JU,L20,4JU,24,9,15,8
L20 4JW,L20,4JW,55,32,23,37
L20 4JX,L20,4JX,26,18,8,19
L20 4JZ,L20,4JZ,12,5,7,5
L20 4LA,L20,4LA,19,11,8,10
L20 4LB,L20,4LB,25,12,13,13
L20 4LE,L20,4LE,72,34,38,33
L20 4LF,L20,4LF,65,30,35,27
L20 4LG,L20,4LG,57,25,32,27
L20 4LH,L20,4LH,40,16,24,15
L20 4LJ,L20,4LJ,38,20,18,26
L20 4LL,L20,4LL,50,27,23,29
L20 4LN,L20,4LN,57,28,29,23
L20 4LP,L20,4LP,15,4,11,4
L20 4LQ,L20,4LQ,44,24,20,25
L20 4LU,L20,4LU,16,7,9,8
L20 4LW,L20,4LW,57,19,38,29
L20 4LX,L20,4LX,5,3,2,1
L20 4LZ,L20,4LZ,2,1,1,1
L20 4NF,L20,4NF,114,59,55,47
L20 4NH,L20,4NH,21,11,10,10
L20 4NJ,L20,4NJ,12,9,3,8
L20 4NL,L20,4NL,14,7,7,6
L20 4NP,L20,4NP,57,26,31,24
L20 4NR,L20,4NR,18,9,9,15
L20 4NU,L20,4NU,6,3,3,3
L20 4NX,L20,4NX,26,11,15,21
L20 4NY,L20,4NY,86,39,47,34
L20 4NZ,L20,4NZ,21,9,12,12
L20 4PA,L20,4PA,35,18,17,27
L20 4PB,L20,4PB,17,8,9,7
L20 4PD,L20,4PD,51,30,21,21
L20 4PE,L20,4PE,80,36,44,33
L20 4PF,L20,4PF,97,54,43,34
L20 4PG,L20,4PG,90,47,43,35
L20 4PH,L20,4PH,63,32,31,34
L20 4PJ,L20,4PJ,67,37,30,26
L20 4PL,L20,4PL,65,34,31,31
L20 4PN,L20,4PN,16,6,10,8
L20 4PQ,L20,4PQ,67,27,40,33
L20 4PR,L20,4PR,60,30,30,26
L20 4PS,L20,4PS,68,34,34,39
L20 4PT,L20,4PT,55,22,33,35
L20 4PU,L20,4PU,64,30,34,35
L20 4PW,L20,4PW,74,32,42,33
L20 4PX,L20,4PX,60,31,29,32
L20 4PY,L20,4PY,43,13,30,0
L20 4PZ,L20,4PZ,19,9,10,10
L20 4QA,L20,4QA,22,11,11,9
L20 4QD,L20,4QD,19,12,7,13
L20 4QE,L20,4QE,70,32,38,38
L20 4QF,L20,4QF,74,36,38,40
L20 4QG,L20,4QG,88,45,43,26
L20 4QH,L20,4QH,82,42,40,37
L20 4QJ,L20,4QJ,39,18,21,14
L20 4QP,L20,4QP,48,21,27,18
L20 4QQ,L20,4QQ,16,6,10,8
L20 4QR,L20,4QR,173,73,100,68
L20 4QT,L20,4QT,26,18,8,18
L20 4RD,L20,4RD,2,1,1,1
L20 4RH,L20,4RH,63,27,36,28
L20 4RJ,L20,4RJ,94,44,50,39
L20 4RL,L20,4RL,53,23,30,22
L20 4RN,L20,4RN,8,4,4,4
L20 4RP,L20,4RP,133,56,77,53
L20 4RR,L20,4RR,76,34,42,35
L20 4RS,L20,4RS,69,36,33,29
L20 4RT,L20,4RT,79,39,40,28
L20 4RU,L20,4RU,76,41,35,29
L20 4RY,L20,4RY,70,30,40,31
L20 4RZ,L20,4RZ,59,29,30,24
L20 4SE,L20,4SE,44,22,22,24
L20 4SF,L20,4SF,71,25,46,40
L20 4SG,L20,4SG,90,43,47,39
L20 4SJ,L20,4SJ,73,46,27,60
L20 4SL,L20,4SL,67,39,28,57
L20 4SQ,L20,4SQ,92,36,56,39
L20 4SW,L20,4SW,11,5,6,8
L20 4TA,L20,4TA,11,5,6,10
L20 4TB,L20,4TB,50,31,19,41
L20 4TD,L20,4TD,85,41,44,32
L20 4TE,L20,4TE,76,47,29,48
L20 4TP,L20,4TP,44,21,23,35
L20 4TQ,L20,4TQ,110,55,55,67
L20 4TR,L20,4TR,21,10,11,8
L20 4TW,L20,4TW,36,21,15,30
L20 4UG,L20,4UG,33,18,15,9
L20 4UH,L20,4UH,67,32,35,34
L20 4UJ,L20,4UJ,29,11,18,14
L20 4UL,L20,4UL,54,33,21,32
L20 4UN,L20,4UN,29,13,16,27
L20 4UP,L20,4UP,8,2,6,8
L20 4US,L20,4US,138,63,75,57
L20 4UT,L20,4UT,41,12,29,16
L20 4UU,L20,4UU,36,22,14,28
L20 4UW,L20,4UW,6,3,3,5
L20 4UY,L20,4UY,34,18,16,17
L20 4UZ,L20,4UZ,33,13,20,17
L20 4XA,L20,4XA,17,8,9,6
L20 4XE,L20,4XE,24,13,11,10
L20 4XY,L20,4XY,114,41,73,35
L20 4YG,L20,4YG,47,26,21,16
L20 5AB,L20,5AB,6,2,4,2
L20 5AE,L20,5AE,22,14,8,15
L20 5AF,L20,5AF,37,21,16,21
L20 5AG,L20,5AG,52,30,22,20
L20 5AH,L20,5AH,35,19,16,15
L20 5AL,L20,5AL,1,0,1,1
L20 5AN,L20,5AN,36,13,23,20
L20 5AP,L20,5AP,21,11,10,9
L20 5AQ,L20,5AQ,45,26,19,20
L20 5AR,L20,5AR,26,7,19,9
L20 5AS,L20,5AS,55,29,26,19
L20 5AT,L20,5AT,29,12,17,14
L20 5AU,L20,5AU,55,27,28,25
L20 5AW,L20,5AW,53,26,27,22
L20 5AX,L20,5AX,73,38,35,25
L20 5AY,L20,5AY,34,16,18,12
L20 5BA,L20,5BA,34,17,17,15
L20 5BB,L20,5BB,38,21,17,15
L20 5BD,L20,5BD,40,15,25,15
L20 5BE,L20,5BE,46,21,25,20
L20 5BG,L20,5BG,42,24,18,20
L20 5BH,L20,5BH,43,21,22,21
L20 5BJ,L20,5BJ,72,34,38,29
L20 5BL,L20,5BL,70,30,40,28
L20 5BN,L20,5BN,2,2,0,2
L20 5BQ,L20,5BQ,16,11,5,9
L20 5BY,L20,5BY,38,17,21,10
L20 5BZ,L20,5BZ,69,37,32,19
L20 5DA,L20,5DA,50,21,29,14
L20 5DB,L20,5DB,53,26,27,18
L20 5DE,L20,5DE,61,35,26,19
L20 5DG,L20,5DG,8,5,3,6
L20 5DJ,L20,5DJ,8,4,4,3
L20 5DN,L20,5DN,23,14,9,15
L20 5DQ,L20,5DQ,60,26,34,22
L20 5DS,L20,5DS,22,9,13,11
L20 5DT,L20,5DT,72,27,45,27
L20 5DU,L20,5DU,71,33,38,28
L20 5DW,L20,5DW,30,17,13,19
L20 5DX,L20,5DX,17,7,10,7
L20 5DY,L20,5DY,43,16,27,16
L20 5DZ,L20,5DZ,34,15,19,13
L20 5EA,L20,5EA,86,34,52,37
L20 5EB,L20,5EB,29,15,14,15
L20 5ED,L20,5ED,42,22,20,19
L20 5EE,L20,5EE,30,14,16,15
L20 5EF,L20,5EF,59,33,26,28
L20 5EG,L20,5EG,15,5,10,8
L20 5EH,L20,5EH,91,37,54,40
L20 5EJ,L20,5EJ,57,28,29,20
L20 5EL,L20,5EL,68,30,38,27
L20 5EN,L20,5EN,52,25,27,27
L20 5EP,L20,5EP,103,49,54,36
L20 5EQ,L20,5EQ,47,25,22,16
L20 5ES,L20,5ES,82,38,44,40
L20 5ET,L20,5ET,37,16,21,14
L20 5EU,L20,5EU,49,22,27,18
L20 5EX,L20,5EX,56,25,31,23
L20 5EY,L20,5EY,63,35,28,33
L20 5EZ,L20,5EZ,90,44,46,44
L20 5GA,L20,5GA,48,25,23,17
L20 5GB,L20,5GB,29,11,18,9
L20 5HF,L20,5HF,41,24,17,35
L20 6AA,L20,6AA,16,8,8,8
L20 6AB,L20,6AB,33,21,12,16
L20 6AG,L20,6AG,72,35,37,24
L20 6AJ,L20,6AJ,76,29,47,27
L20 6AL,L20,6AL,11,3,8,5
L20 6AN,L20,6AN,10,7,3,8
L20 6AP,L20,6AP,61,28,33,24
L20 6AQ,L20,6AQ,70,27,43,25
L20 6AR,L20,6AR,50,26,24,24
L20 6AS,L20,6AS,70,33,37,22
L20 6AT,L20,6AT,66,33,33,26
L20 6AU,L20,6AU,6,2,4,3
L20 6AW,L20,6AW,31,13,18,13
L20 6BA,L20,6BA,5,3,2,3
L20 6BB,L20,6BB,33,15,18,13
L20 6BD,L20,6BD,43,15,28,24
L20 6BF,L20,6BF,15,7,8,5
L20 6BH,L20,6BH,6,4,2,1
L20 6BJ,L20,6BJ,4,1,3,3
L20 6BN,L20,6BN,4,2,2,2
L20 6BP,L20,6BP,7,2,5,4
L20 6BQ,L20,6BQ,74,35,39,26
L20 6BR,L20,6BR,9,4,5,5
L20 6DA,L20,6DA,55,28,27,26
L20 6DB,L20,6DB,44,22,22,16
L20 6DD,L20,6DD,3,1,2,2
L20 6DF,L20,6DF,2,0,2,1
L20 6DH,L20,6DH,74,33,41,30
L20 6DJ,L20,6DJ,74,32,42,30
L20 6DL,L20,6DL,50,21,29,20
L20 6DN,L20,6DN,77,38,39,29
L20 6DP,L20,6DP,75,24,51,12
L20 6DQ,L20,6DQ,46,20,26,16
L20 6DR,L20,6DR,26,13,13,13
L20 6DS,L20,6DS,35,15,20,19
L20 6DT,L20,6DT,88,46,42,25
L20 6DU,L20,6DU,28,16,12,11
L20 6DW,L20,6DW,81,40,41,26
L20 6DX,L20,6DX,30,14,16,12
L20 6DY,L20,6DY,61,28,33,26
L20 6EA,L20,6EA,60,30,30,24
L20 6EB,L20,6EB,46,24,22,19
L20 6ED,L20,6ED,27,16,11,9
L20 6EE,L20,6EE,70,35,35,26
L20 6EF,L20,6EF,93,50,43,36
L20 6EG,L20,6EG,41,16,25,14
L20 6EH,L20,6EH,26,16,10,12
L20 6EJ,L20,6EJ,99,45,54,38
L20 6EL,L20,6EL,26,15,11,8
L20 6EN,L20,6EN,35,17,18,16
L20 6EP,L20,6EP,64,35,29,26
L20 6EQ,L20,6EQ,63,29,34,25
L20 6ER,L20,6ER,103,51,52,37
L20 6ES,L20,6ES,53,27,26,19
L20 6ET,L20,6ET,90,46,44,34
L20 6EU,L20,6EU,37,17,20,17
L20 6EW,L20,6EW,72,31,41,22
L20 6EX,L20,6EX,36,12,24,16
L20 6EY,L20,6EY,29,13,16,11
L20 6EZ,L20,6EZ,34,18,16,17
L20 6GD,L20,6GD,158,75,83,78
L20 6GE,L20,6GE,73,37,36,33
L20 6GF,L20,6GF,83,39,44,49
L20 6HA,L20,6HA,33,17,16,14
L20 6HB,L20,6HB,31,14,17,12
L20 6HD,L20,6HD,10,7,3,4
L20 6HE,L20,6HE,34,14,20,16
L20 6HF,L20,6HF,44,21,23,18
L20 6HG,L20,6HG,48,27,21,18
L20 6HJ,L20,6HJ,53,29,24,32
L20 6HL,L20,6HL,19,10,9,12
L20 6HN,L20,6HN,66,29,37,26
L20 6HP,L20,6HP,20,9,11,12
L20 6HQ,L20,6HQ,37,19,18,19
L20 6HR,L20,6HR,69,29,40,32
L20 6HS,L20,6HS,22,8,14,12
L20 6HT,L20,6HT,20,13,7,12
L20 6HU,L20,6HU,46,20,26,17
L20 6HW,L20,6HW,58,24,34,24
L20 6HX,L20,6HX,39,20,19,13
L20 6HY,L20,6HY,42,14,28,16
L20 6HZ,L20,6HZ,52,25,27,25
L20 6JA,L20,6JA,36,17,19,16
L20 6JB,L20,6JB,89,41,48,48
L20 6JD,L20,6JD,12,3,9,4
L20 6JE,L20,6JE,46,22,24,20
L20 6JF,L20,6JF,43,26,17,15
L20 6JG,L20,6JG,78,38,40,31
L20 6JJ,L20,6JJ,4,2,2,1
L20 6JQ,L20,6JQ,73,39,34,23
L20 6JU,L20,6JU,55,26,29,24
L20 6JY,L20,6JY,53,26,27,26
L20 6LD,L20,6LD,41,20,21,17
L20 6LE,L20,6LE,25,9,16,11
L20 6LF,L20,6LF,24,14,10,10
L20 6LG,L20,6LG,49,24,25,20
L20 6LH,L20,6LH,19,9,10,5
L20 6LJ,L20,6LJ,52,29,23,22
L20 6LL,L20,6LL,25,14,11,10
L20 6LN,L20,6LN,46,25,21,18
L20 6LP,L20,6LP,15,8,7,7
L20 6LQ,L20,6LQ,21,6,15,11
L20 6LR,L20,6LR,24,10,14,9
L20 6LS,L20,6LS,9,4,5,5
L20 6LT,L20,6LT,76,34,42,32
L20 6LU,L20,6LU,13,5,8,9
L20 6LW,L20,6LW,85,40,45,34
L20 6LX,L20,6LX,69,33,36,26
L20 6LY,L20,6LY,6,2,4,4
L20 6LZ,L20,6LZ,41,24,17,18
L20 6NA,L20,6NA,23,10,13,13
L20 6NB,L20,6NB,6,2,4,3
L20 6ND,L20,6ND,73,37,36,26
L20 6NE,L20,6NE,47,22,25,20
L20 6NF,L20,6NF,60,28,32,24
L20 6NG,L20,6NG,33,14,19,16
L20 6NH,L20,6NH,48,22,26,24
L20 6NJ,L20,6NJ,68,30,38,26
L20 6NL,L20,6NL,53,27,26,27
L20 6NN,L20,6NN,69,34,35,28
L20 6NQ,L20,6NQ,18,10,8,11
L20 6NU,L20,6NU,29,16,13,13
L20 6PR,L20,6PR,48,21,27,43
L20 7AA,L20,7AA,52,37,15,32
L20 7AB,L20,7AB,26,18,8,18
L20 7AH,L20,7AH,49,18,31,8
L20 7AJ,L20,7AJ,86,53,33,20
L20 7AL,L20,7AL,91,48,43,32
L20 7AN,L20,7AN,18,11,7,11
L20 7AP,L20,7AP,23,15,8,3
L20 7AT,L20,7AT,8,4,4,3
L20 7AZ,L20,7AZ,36,18,18,17
L20 7BA,L20,7BA,25,14,11,11
L20 7BB,L20,7BB,19,12,7,11
L20 7BD,L20,7BD,15,6,9,7
L20 7BG,L20,7BG,21,10,11,14
L20 7BL,L20,7BL,12,7,5,6
L20 7BN,L20,7BN,32,18,14,22
L20 7BQ,L20,7BQ,29,17,12,10
L20 7BS,L20,7BS,8,5,3,2
L20 7BT,L20,7BT,32,15,17,11
L20 7BW,L20,7BW,36,17,19,13
L20 7BX,L20,7BX,20,12,8,12
L20 7BY,L20,7BY,3,1,2,2
L20 7BZ,L20,7BZ,18,11,7,14
L20 7DA,L20,7DA,11,6,5,7
L20 7DB,L20,7DB,9,8,1,6
L20 7DF,L20,7DF,71,31,40,29
L20 7DG,L20,7DG,87,43,44,30
L20 7DH,L20,7DH,36,20,16,17
L20 7DJ,L20,7DJ,12,7,5,6
L20 7DL,L20,7DL,52,25,27,20
L20 7DN,L20,7DN,66,27,39,24
L20 7DP,L20,7DP,21,7,14,14
L20 7DQ,L20,7DQ,134,72,62,46
L20 7DR,L20,7DR,78,33,45,42
L20 7DS,L20,7DS,27,14,13,15
L20 7DT,L20,7DT,84,41,43,56
L20 7DU,L20,7DU,55,26,29,27
L20 7DW,L20,7DW,50,28,22,21
L20 7DX,L20,7DX,38,21,17,25
L20 7EE,L20,7EE,84,36,48,38
L20 7EJ,L20,7EJ,34,15,19,1
L20 7ES,L20,7ES,1,1,0,1
L20 7EX,L20,7EX,69,31,38,24
L20 7EZ,L20,7EZ,45,26,19,39
L20 7HE,L20,7HE,28,15,13,13
L20 7HF,L20,7HF,30,17,13,28
L20 7HH,L20,7HH,5,4,1,5
L20 7HJ,L20,7HJ,13,8,5,12
L20 7HL,L20,7HL,12,7,5,11
L20 7HN,L20,7HN,13,9,4,11
L20 7HQ,L20,7HQ,15,7,8,12
L20 7HR,L20,7HR,11,7,4,9
L20 7JH,L20,7JH,33,14,19,12
L20 7JJ,L20,7JJ,16,5,11,6
L20 8BX,L20,8BX,2,1,1,1
L20 8EE,L20,8EE,1,0,1,1
L20 8LA,L20,8LA,12,7,5,5
L20 8LD,L20,8LD,4,3,1,3
L20 8LF,L20,8LF,12,7,5,7
L20 8LG,L20,8LG,21,13,8,10
L20 8LJ,L20,8LJ,5,3,2,3
L20 8LX,L20,8LX,80,42,38,45
L20 8LY,L20,8LY,53,26,27,21
L20 8NA,L20,8NA,50,20,30,21
L20 8NB,L20,8NB,22,12,10,7
L20 8ND,L20,8ND,31,15,16,11
L20 9AA,L20,9AA,107,55,52,47
L20 9AB,L20,9AB,90,49,41,26
L20 9AD,L20,9AD,14,6,8,5
L20 9AE,L20,9AE,92,45,47,34
L20 9AF,L20,9AF,58,38,20,46
L20 9AG,L20,9AG,60,31,29,23
L20 9AH,L20,9AH,62,30,32,24
L20 9AJ,L20,9AJ,80,36,44,37
L20 9AL,L20,9AL,102,46,56,40
L20 9AN,L20,9AN,109,51,58,45
L20 9AP,L20,9AP,84,40,44,33
L20 9AQ,L20,9AQ,36,12,24,12
L20 9AT,L20,9AT,32,16,16,13
L20 9AU,L20,9AU,20,7,13,11
L20 9AW,L20,9AW,83,44,39,31
L20 9AX,L20,9AX,66,26,40,35
L20 9AY,L20,9AY,19,8,11,8
L20 9AZ,L20,9AZ,61,32,29,22
L20 9BA,L20,9BA,25,15,10,14
L20 9BD,L20,9BD,9,6,3,7
L20 9BN,L20,9BN,59,27,32,24
L20 9BP,L20,9BP,58,31,27,21
L20 9BR,L20,9BR,46,23,23,21
L20 9BS,L20,9BS,48,26,22,18
L20 9BT,L20,9BT,71,32,39,29
L20 9BU,L20,9BU,38,16,22,15
L20 9BW,L20,9BW,53,26,27,19
L20 9BX,L20,9BX,16,10,6,9
L20 9BY,L20,9BY,74,40,34,28
L20 9BZ,L20,9BZ,73,39,34,25
L20 9DE,L20,9DE,3,1,2,1
L20 9DN,L20,9DN,17,6,11,11
L20 9DP,L20,9DP,52,27,25,24
L20 9DR,L20,9DR,65,28,37,22
L20 9DS,L20,9DS,50,21,29,21
L20 9DT,L20,9DT,44,23,21,17
L20 9DU,L20,9DU,4,2,2,3
L20 9DX,L20,9DX,3,2,1,1
L20 9DY,L20,9DY,64,37,27,23
L20 9DZ,L20,9DZ,16,7,9,8
L20 9EB,L20,9EB,25,13,12,9
L20 9ED,L20,9ED,44,23,21,16
L20 9EE,L20,9EE,48,20,28,24
L20 9EF,L20,9EF,62,31,31,25
L20 9EG,L20,9EG,60,28,32,24
L20 9EH,L20,9EH,43,23,20,17
L20 9EJ,L20,9EJ,37,15,22,15
L20 9EL,L20,9EL,38,18,20,16
L20 9EN,L20,9EN,43,23,20,21
L20 9EP,L20,9EP,28,13,15,11
L20 9ER,L20,9ER,78,30,48,27
L20 9ES,L20,9ES,61,33,28,26
L20 9ET,L20,9ET,71,30,41,28
L20 9EU,L20,9EU,50,24,26,18
L20 9EW,L20,9EW,81,38,43,37
L20 9EX,L20,9EX,44,21,23,19
L20 9EY,L20,9EY,27,14,13,14
L20 9GA,L20,9GA,1,1,0,1
L20 9HA,L20,9HA,29,12,17,10
L20 9HB,L20,9HB,18,7,11,10
L20 9HD,L20,9HD,59,30,29,20
L20 9HE,L20,9HE,77,35,42,29
L20 9HF,L20,9HF,8,3,5,3
L20 9HG,L20,9HG,41,20,21,15
L20 9HJ,L20,9HJ,9,6,3,4
L20 9HL,L20,9HL,16,10,6,6
L20 9HN,L20,9HN,25,13,12,12
L20 9HP,L20,9HP,1,0,1,1
L20 9HR,L20,9HR,33,17,16,14
L20 9HS,L20,9HS,15,7,8,8
L20 9HT,L20,9HT,9,3,6,7
L20 9HU,L20,9HU,62,31,31,22
L20 9HW,L20,9HW,79,36,43,23
L20 9HX,L20,9HX,39,21,18,12
L20 9HY,L20,9HY,18,6,12,8
L20 9HZ,L20,9HZ,61,22,39,23
L20 9JA,L20,9JA,55,25,30,22
L20 9JB,L20,9JB,45,23,22,21
L20 9JD,L20,9JD,27,14,13,9
L20 9JE,L20,9JE,96,44,52,36
L20 9JF,L20,9JF,32,10,22,12
L20 9JG,L20,9JG,38,16,22,13
L20 9JH,L20,9JH,38,19,19,14
L20 9JJ,L20,9JJ,62,32,30,25
L20 9JL,L20,9JL,33,14,19,12
L20 9JN,L20,9JN,62,34,28,23
L20 9JP,L20,9JP,25,14,11,9
L20 9JQ,L20,9JQ,23,13,10,7
L20 9JR,L20,9JR,64,26,38,26
L20 9JS,L20,9JS,57,23,34,46
L20 9JT,L20,9JT,60,26,34,45
L20 9JU,L20,9JU,45,13,32,22
L20 9JW,L20,9JW,28,15,13,14
L20 9JX,L20,9JX,48,20,28,17
L20 9JY,L20,9JY,18,7,11,12
L20 9LA,L20,9LA,65,27,38,24
L20 9LB,L20,9LB,62,27,35,28
L20 9LD,L20,9LD,54,17,37,21
L20 9LE,L20,9LE,38,17,21,12
L20 9LF,L20,9LF,43,19,24,18
L20 9LG,L20,9LG,42,20,22,17
L20 9LH,L20,9LH,76,35,41,30
L20 9LJ,L20,9LJ,66,31,35,26
L20 9LL,L20,9LL,21,8,13,10
L20 9LN,L20,9LN,44,24,20,19
L20 9LP,L20,9LP,53,28,25,23
L20 9LQ,L20,9LQ,69,33,36,25
L20 9LR,L20,9LR,83,41,42,31
L20 9LS,L20,9LS,50,24,26,20
L20 9LT,L20,9LT,85,37,48,29
L20 9LU,L20,9LU,61,29,32,19
L20 9LW,L20,9LW,74,34,40,30
L20 9LX,L20,9LX,94,54,40,35
L20 9LY,L20,9LY,71,32,39,23
L20 9LZ,L20,9LZ,62,26,36,25
L20 9NA,L20,9NA,77,38,39,29
L20 9NB,L20,9NB,51,22,29,22
L20 9ND,L20,9ND,84,42,42,34
L20 9NE,L20,9NE,27,14,13,9
L20 9NG,L20,9NG,15,10,5,7
L20 9NH,L20,9NH,17,10,7,15
L20 9NJ,L20,9NJ,42,21,21,16
L20 9NL,L20,9NL,51,26,25,20
L20 9NN,L20,9NN,15,6,9,6
L20 9NP,L20,9NP,57,27,30,20
L20 9NR,L20,9NR,29,9,20,14
L20 9NS,L20,9NS,6,3,3,2
L20 9NT,L20,9NT,72,35,37,24
L20 9NU,L20,9NU,3,1,2,1
L20 9NX,L20,9NX,31,13,18,22
L20 9NY,L20,9NY,9,4,5,6
L20 9NZ,L20,9NZ,1,0,1,1
L20 9PA,L20,9PA,26,12,14,12
L20 9PF,L20,9PF,30,16,14,10
L20 9PR,L20,9PR,2,2,0,1
L20 9PS,L20,9PS,35,16,19,0
L20 9QB,L20,9QB,21,8,13,8
L20 9QD,L20,9QD,16,10,6,6
L20 9QE,L20,9QE,22,8,14,9
L21 0DA,L21,0DA,19,7,12,7
L21 0DD,L21,0DD,31,12,19,11
L21 0DE,L21,0DE,56,24,32,29
L21 0DF,L21,0DF,10,5,5,7
L21 0DG,L21,0DG,34,13,21,17
L21 0DH,L21,0DH,20,8,12,12
L21 0DJ,L21,0DJ,28,8,20,16
L21 0DN,L21,0DN,70,32,38,28
L21 0DP,L21,0DP,45,27,18,27
L21 0DQ,L21,0DQ,28,17,11,11
L21 0DR,L21,0DR,62,29,33,26
L21 0DS,L21,0DS,57,27,30,22
L21 0DT,L21,0DT,62,30,32,21
L21 0DU,L21,0DU,91,40,51,32
L21 0DW,L21,0DW,64,34,30,23
L21 0DX,L21,0DX,58,23,35,28
L21 0DY,L21,0DY,41,20,21,18
L21 0DZ,L21,0DZ,41,22,19,20
L21 0EA,L21,0EA,34,15,19,16
L21 0EB,L21,0EB,26,13,13,11
L21 0ED,L21,0ED,54,25,29,23
L21 0EE,L21,0EE,47,20,27,22
L21 0EF,L21,0EF,18,8,10,12
L21 0EG,L21,0EG,77,35,42,34
L21 0EH,L21,0EH,12,6,6,4
L21 0EJ,L21,0EJ,2,2,0,1
L21 0EL,L21,0EL,43,21,22,14
L21 0EN,L21,0EN,70,26,44,32
L21 0EP,L21,0EP,12,8,4,7
L21 0EQ,L21,0EQ,89,39,50,35
L21 0ER,L21,0ER,58,28,30,30
L21 0ES,L21,0ES,64,27,37,24
L21 0ET,L21,0ET,70,32,38,34
L21 0EU,L21,0EU,29,17,12,15
L21 0EW,L21,0EW,48,28,20,20
L21 0EX,L21,0EX,29,15,14,16
L21 0EY,L21,0EY,63,36,27,26
L21 0EZ,L21,0EZ,47,24,23,24
L21 0HA,L21,0HA,26,14,12,11
L21 0HB,L21,0HB,23,13,10,8
L21 0HD,L21,0HD,32,17,15,20
L21 0HE,L21,0HE,60,25,35,24
L21 0HF,L21,0HF,35,15,20,20
L21 0HG,L21,0HG,28,13,15,12
L21 0HH,L21,0HH,43,26,17,15
L21 0HJ,L21,0HJ,98,48,50,43
L21 0HL,L21,0HL,72,31,41,41
L21 0HN,L21,0HN,81,45,36,49
L21 0HP,L21,0HP,48,23,25,13
L21 0HQ,L21,0HQ,46,22,24,21
L21 0HR,L21,0HR,60,26,34,32
L21 0HS,L21,0HS,25,14,11,11
L21 0HT,L21,0HT,60,26,34,33
L21 0HU,L21,0HU,12,5,7,6
L21 0HW,L21,0HW,39,14,25,26
L21 0HX,L21,0HX,142,66,76,57
L21 0HY,L21,0HY,64,30,34,19
L21 0HZ,L21,0HZ,99,46,53,40
L21 0JA,L21,0JA,117,59,58,46
L21 0JB,L21,0JB,71,29,42,29
L21 0JD,L21,0JD,61,30,31,22
L21 0JE,L21,0JE,61,29,32,24
L21 0JG,L21,0JG,9,5,4,8
L21 0JH,L21,0JH,126,60,66,51
L21 0JJ,L21,0JJ,119,56,63,47
L21 0JL,L21,0JL,117,58,59,41
L21 0JP,L21,0JP,15,6,9,6
L21 0JQ,L21,0JQ,105,47,58,51
L21 0JW,L21,0JW,128,61,67,58
L21 0JZ,L21,0JZ,10,5,5,4
L21 1AD,L21,1AD,20,10,10,7
L21 1AE,L21,1AE,26,18,8,20
L21 1AF,L21,1AF,37,14,23,17
L21 1AG,L21,1AG,71,32,39,24
L21 1AH,L21,1AH,82,32,50,35
L21 1AJ,L21,1AJ,26,12,14,9
L21 1AL,L21,1AL,41,16,25,14
L21 1AN,L21,1AN,49,19,30,24
L21 1AP,L21,1AP,51,30,21,39
L21 1AR,L21,1AR,38,19,19,13
L21 1AS,L21,1AS,41,16,25,16
L21 1AT,L21,1AT,86,43,43,28
L21 1AU,L21,1AU,54,45,9,45
L21 1AW,L21,1AW,21,11,10,9
L21 1BA,L21,1BA,56,37,19,45
L21 1BB,L21,1BB,58,21,37,24
L21 1BD,L21,1BD,86,48,38,32
L21 1BE,L21,1BE,41,14,27,18
L21 1BH,L21,1BH,13,10,3,4
L21 1BJ,L21,1BJ,65,32,33,21
L21 1BL,L21,1BL,67,30,37,25
L21 1BN,L21,1BN,95,54,41,34
L21 1BP,L21,1BP,108,50,58,38
L21 1BR,L21,1BR,87,48,39,36
L21 1BS,L21,1BS,17,8,9,10
L21 1BT,L21,1BT,35,15,20,15
L21 1BU,L21,1BU,14,7,7,11
L21 1BX,L21,1BX,42,24,18,18
L21 1BY,L21,1BY,24,10,14,8
L21 1BZ,L21,1BZ,38,18,20,14
L21 1DA,L21,1DA,15,6,9,6
L21 1DB,L21,1DB,50,22,28,23
L21 1DD,L21,1DD,48,21,27,21
L21 1DE,L21,1DE,20,8,12,6
L21 1DG,L21,1DG,61,28,33,17
L21 1DH,L21,1DH,22,14,8,12
L21 1DJ,L21,1DJ,16,9,7,6
L21 1DN,L21,1DN,12,1,11,4
L21 1DP,L21,1DP,52,25,27,24
L21 1DQ,L21,1DQ,25,11,14,12
L21 1DR,L21,1DR,68,34,34,23
L21 1DS,L21,1DS,75,43,32,21
L21 1DT,L21,1DT,64,29,35,27
L21 1DU,L21,1DU,68,47,21,46
L21 1DW,L21,1DW,76,42,34,32
L21 1DX,L21,1DX,52,23,29,20
L21 1DY,L21,1DY,54,25,29,20
L21 1DZ,L21,1DZ,60,28,32,20
L21 1EB,L21,1EB,14,8,6,4
L21 1EE,L21,1EE,43,20,23,20
L21 1EF,L21,1EF,43,20,23,19
L21 1EG,L21,1EG,36,13,23,17
L21 1EH,L21,1EH,37,11,26,18
L21 1EJ,L21,1EJ,68,31,37,27
L21 1EL,L21,1EL,74,36,38,33
L21 1EN,L21,1EN,60,38,22,46
L21 1EQ,L21,1EQ,27,14,13,16
L21 1ER,L21,1ER,28,18,10,16
L21 1ES,L21,1ES,14,8,6,7
L21 1EW,L21,1EW,68,27,41,20
L21 1EX,L21,1EX,44,22,22,20
L21 1EY,L21,1EY,27,15,12,16
L21 1EZ,L21,1EZ,38,17,21,14
L21 1HA,L21,1HA,47,19,28,27
L21 1HD,L21,1HD,48,24,24,26
L21 1HG,L21,1HG,55,26,29,23
L21 1HJ,L21,1HJ,58,32,26,28
L21 1HL,L21,1HL,45,20,25,17
L21 1HP,L21,1HP,19,7,12,8
L21 1HQ,L21,1HQ,46,21,25,26
L21 1HR,L21,1HR,11,6,5,6
L21 1HS,L21,1HS,31,24,7,18
L21 1HT,L21,1HT,93,46,47,43
L21 1HU,L21,1HU,16,12,4,12
L21 1HX,L21,1HX,43,21,22,23
L21 1JF,L21,1JF,38,20,18,25
L21 1JG,L21,1JG,28,15,13,16
L21 1JQ,L21,1JQ,83,41,42,34
L21 1JW,L21,1JW,82,39,43,29
L21 2NA,L21,2NA,20,9,11,9
L21 2NB,L21,2NB,49,23,26,18
L21 2ND,L21,2ND,37,14,23,14
L21 2NE,L21,2NE,19,7,12,11
L21 2PA,L21,2PA,6,2,4,3
L21 2PB,L21,2PB,15,8,7,5
L21 2PE,L21,2PE,74,38,36,53
L21 2PG,L21,2PG,32,17,15,13
L21 2PJ,L21,2PJ,91,46,45,40
L21 2PN,L21,2PN,26,11,15,13
L21 2PP,L21,2PP,17,5,12,9
L21 2PQ,L21,2PQ,22,12,10,6
L21 2PR,L21,2PR,82,45,37,30
L21 2PS,L21,2PS,82,38,44,39
L21 2PT,L21,2PT,71,36,35,31
L21 2PU,L21,2PU,88,47,41,31
L21 2PW,L21,2PW,39,20,19,16
L21 2PX,L21,2PX,79,44,35,34
L21 2PY,L21,2PY,74,34,40,29
L21 2QH,L21,2QH,93,39,54,32
L21 2QJ,L21,2QJ,13,5,8,8
L21 2QL,L21,2QL,37,18,19,12
L21 2QN,L21,2QN,37,18,19,16
L21 3TA,L21,3TA,2,0,2,1
L21 3TB,L21,3TB,8,6,2,6
L21 3TD,L21,3TD,93,50,43,46
L21 3TE,L21,3TE,13,6,7,4
L21 3TF,L21,3TF,17,9,8,10
L21 3TJ,L21,3TJ,4,2,2,1
L21 3TN,L21,3TN,5,3,2,2
L21 3TP,L21,3TP,10,5,5,5
L21 3TR,L21,3TR,38,16,22,22
L21 3TS,L21,3TS,47,24,23,18
L21 3TT,L21,3TT,109,49,60,38
L21 3TX,L21,3TX,15,11,4,10
L21 3TY,L21,3TY,4,3,1,1
L21 3TZ,L21,3TZ,53,25,28,32
L21 3UA,L21,3UA,36,18,18,16
L21 3UB,L21,3UB,6,3,3,2
L21 3UD,L21,3UD,13,4,9,11
L21 4LA,L21,4LA,4,1,3,2
L21 4LB,L21,4LB,59,24,35,27
L21 4LD,L21,4LD,18,10,8,12
L21 4LE,L21,4LE,3,1,2,3
L21 4LF,L21,4LF,21,11,10,7
L21 4LG,L21,4LG,21,13,8,8
L21 4LJ,L21,4LJ,2,2,0,1
L21 4LL,L21,4LL,56,23,33,29
L21 4LN,L21,4LN,57,26,31,21
L21 4LP,L21,4LP,37,18,19,17
L21 4LR,L21,4LR,22,11,11,10
L21 4LU,L21,4LU,1,0,1,1
L21 4LW,L21,4LW,43,18,25,22
L21 4LX,L21,4LX,97,47,50,37
L21 4LY,L21,4LY,73,52,21,56
L21 4LZ,L21,4LZ,36,15,21,12
L21 4NA,L21,4NA,43,22,21,18
L21 4NB,L21,4NB,75,33,42,32
L21 4ND,L21,4ND,2,0,2,2
L21 4NH,L21,4NH,22,10,12,11
L21 4NN,L21,4NN,78,41,37,35
L21 4NP,L21,4NP,68,34,34,32
L21 4NR,L21,4NR,21,6,15,12
L21 4NS,L21,4NS,90,37,53,40
L21 4NT,L21,4NT,50,25,25,23
L21 4NU,L21,4NU,80,35,45,34
L21 4NW,L21,4NW,95,47,48,41
L21 4PA,L21,4PA,41,17,24,22
L21 4PD,L21,4PD,30,19,11,25
L21 4PJ,L21,4PJ,16,9,7,7
L21 4PL,L21,4PL,101,42,59,42
L21 4PN,L21,4PN,45,23,22,39
L21 4PQ,L21,4PQ,60,18,42,48
L21 4PW,L21,4PW,51,26,25,22
L21 4PZ,L21,4PZ,15,7,8,6
L21 5HA,L21,5HA,9,6,3,5
L21 5HB,L21,5HB,54,24,30,22
L21 5HD,L21,5HD,53,24,29,20
L21 5HE,L21,5HE,53,25,28,20
L21 5HF,L21,5HF,50,25,25,21
L21 5HG,L21,5HG,47,20,27,20
L21 5HH,L21,5HH,50,23,27,20
L21 5HJ,L21,5HJ,61,31,30,18
L21 5HL,L21,5HL,35,18,17,10
L21 5HN,L21,5HN,43,24,19,19
L21 5HP,L21,5HP,30,15,15,14
L21 5HQ,L21,5HQ,62,31,31,20
L21 5HR,L21,5HR,45,22,23,25
L21 5HS,L21,5HS,58,29,29,21
L21 5HT,L21,5HT,50,25,25,22
L21 5HU,L21,5HU,37,15,22,19
L21 5HW,L21,5HW,31,17,14,14
L21 5HX,L21,5HX,41,21,20,16
L21 5HY,L21,5HY,11,3,8,8
L21 5HZ,L21,5HZ,13,5,8,4
L21 5JA,L21,5JA,76,37,39,29
L21 5JB,L21,5JB,58,26,32,20
L21 5JD,L21,5JD,45,20,25,22
L21 5JE,L21,5JE,49,20,29,22
L21 5JF,L21,5JF,47,25,22,19
L21 5JG,L21,5JG,48,20,28,28
L21 5JH,L21,5JH,37,19,18,19
L21 5JJ,L21,5JJ,72,33,39,26
L21 5JL,L21,5JL,78,38,40,27
L21 5JN,L21,5JN,55,28,27,20
L21 5JP,L21,5JP,53,30,23,20
L21 5JQ,L21,5JQ,51,23,28,22
L21 5JR,L21,5JR,42,23,19,13
L21 5JS,L21,5JS,39,17,22,14
L21 5JT,L21,5JT,44,20,24,18
L21 5JU,L21,5JU,57,28,29,18
L21 5JW,L21,5JW,51,27,24,19
L21 5JX,L21,5JX,78,41,37,29
L21 6NA,L21,6NA,78,39,39,29
L21 6NB,L21,6NB,64,30,34,23
L21 6ND,L21,6ND,84,32,52,39
L21 6NE,L21,6NE,41,14,27,17
L21 6NF,L21,6NF,66,31,35,27
L21 6NG,L21,6NG,73,35,38,27
L21 6NH,L21,6NH,82,35,47,29
L21 6NJ,L21,6NJ,43,18,25,16
L21 6NL,L21,6NL,38,16,22,18
L21 6NP,L21,6NP,147,63,84,51
L21 6NQ,L21,6NQ,61,26,35,24
L21 6NR,L21,6NR,33,14,19,9
L21 6NT,L21,6NT,31,19,12,17
L21 6NU,L21,6NU,13,10,3,6
L21 6NX,L21,6NX,76,31,45,31
L21 6NY,L21,6NY,20,10,10,17
L21 6NZ,L21,6NZ,84,33,51,32
L21 6PG,L21,6PG,2,1,1,1
L21 6PH,L21,6PH,9,5,4,4
L21 6PU,L21,6PU,40,16,24,14
L21 7GB,L21,7GB,75,31,44,26
L21 7GD,L21,7GD,62,36,26,44
L21 7LA,L21,7LA,46,23,23,17
L21 7LB,L21,7LB,8,5,3,5
L21 7LE,L21,7LE,12,3,9,5
L21 7LH,L21,7LH,30,16,14,11
L21 7LJ,L21,7LJ,44,22,22,22
L21 7LL,L21,7LL,42,23,19,16
L21 7LN,L21,7LN,78,39,39,30
L21 7LP,L21,7LP,8,6,2,3
L21 7LQ,L21,7LQ,37,21,16,15
L21 7LR,L21,7LR,25,11,14,12
L21 7LS,L21,7LS,27,15,12,10
L21 7LT,L21,7LT,65,34,31,23
L21 7LU,L21,7LU,40,18,22,16
L21 7LW,L21,7LW,53,29,24,20
L21 7LY,L21,7LY,33,17,16,11
L21 7LZ,L21,7LZ,15,9,6,6
L21 7NA,L21,7NA,81,41,40,27
L21 7NB,L21,7NB,66,28,38,26
L21 7ND,L21,7ND,34,16,18,12
L21 7NE,L21,7NE,37,11,26,17
L21 7NF,L21,7NF,61,28,33,22
L21 7NG,L21,7NG,62,29,33,24
L21 7NH,L21,7NH,33,18,15,12
L21 7NJ,L21,7NJ,6,3,3,3
L21 7NL,L21,7NL,43,18,25,17
L21 7NN,L21,7NN,44,23,21,15
L21 7NP,L21,7NP,5,3,2,2
L21 7NQ,L21,7NQ,53,24,29,18
L21 7NR,L21,7NR,17,5,12,4
L21 7NS,L21,7NS,16,12,4,12
L21 7NT,L21,7NT,22,12,10,11
L21 7NU,L21,7NU,6,2,4,4
L21 7NX,L21,7NX,83,42,41,42
L21 7PA,L21,7PA,43,13,30,36
L21 7PB,L21,7PB,4,1,3,2
L21 7PD,L21,7PD,14,7,7,6
L21 7PE,L21,7PE,58,25,33,23
L21 7PF,L21,7PF,45,19,26,24
L21 7PG,L21,7PG,2,1,1,1
L21 7PJ,L21,7PJ,5,1,4,2
L21 7PN,L21,7PN,60,37,23,31
L21 7PP,L21,7PP,7,5,2,6
L21 7PQ,L21,7PQ,11,5,6,5
L21 7PR,L21,7PR,34,15,19,14
L21 7PS,L21,7PS,98,43,55,31
L21 7PT,L21,7PT,68,35,33,28
L21 7PX,L21,7PX,23,11,12,14
L21 7PY,L21,7PY,35,15,20,15
L21 7PZ,L21,7PZ,76,32,44,28
L21 7QA,L21,7QA,19,6,13,11
L21 7QB,L21,7QB,87,44,43,40
L21 7QD,L21,7QD,37,17,20,12
L21 7QE,L21,7QE,88,44,44,32
L21 7QF,L21,7QF,93,46,47,32
L21 7QG,L21,7QG,100,45,55,36
L21 7QH,L21,7QH,70,32,38,30
L21 7QJ,L21,7QJ,71,37,34,29
L21 7QL,L21,7QL,32,14,18,12
L21 7QN,L21,7QN,75,37,38,27
L21 7QP,L21,7QP,88,44,44,33
L21 7QQ,L21,7QQ,133,60,73,44
L21 7QR,L21,7QR,80,40,40,28
L21 7QS,L21,7QS,16,4,12,8
L21 7QW,L21,7QW,63,32,31,24
L21 7QX,L21,7QX,52,26,26,46
L21 7QY,L21,7QY,45,24,21,41
L21 7QZ,L21,7QZ,134,61,73,59
L21 7RA,L21,7RA,44,21,23,14
L21 7RB,L21,7RB,40,17,23,19
L21 7RD,L21,7RD,34,18,16,15
L21 7RE,L21,7RE,62,24,38,27
L21 7RF,L21,7RF,40,20,20,15
L21 7RH,L21,7RH,27,13,14,11
L21 8HD,L21,8HD,71,40,31,51
L21 8HE,L21,8HE,19,10,9,11
L21 8HG,L21,8HG,72,28,44,34
L21 8HH,L21,8HH,83,45,38,37
L21 8HJ,L21,8HJ,92,45,47,37
L21 8HL,L21,8HL,52,26,26,24
L21 8HN,L21,8HN,76,31,45,37
L21 8HQ,L21,8HQ,68,29,39,31
L21 8HS,L21,8HS,42,17,25,19
L21 8HT,L21,8HT,40,16,24,25
L21 8HU,L21,8HU,40,18,22,25
L21 8HW,L21,8HW,95,40,55,46
L21 8HX,L21,8HX,41,16,25,28
L21 8HY,L21,8HY,63,27,36,33
L21 8HZ,L21,8HZ,9,3,6,4
L21 8JA,L21,8JA,33,17,16,18
L21 8JB,L21,8JB,86,47,39,30
L21 8JD,L21,8JD,25,12,13,13
L21 8JE,L21,8JE,59,23,36,25
L21 8JF,L21,8JF,40,18,22,16
L21 8JG,L21,8JG,55,32,23,23
L21 8JH,L21,8JH,1,1,0,1
L21 8JN,L21,8JN,39,14,25,18
L21 8JP,L21,8JP,12,10,2,11
L21 8JQ,L21,8JQ,57,22,35,25
L21 8JS,L21,8JS,14,11,3,11
L21 8JT,L21,8JT,12,12,0,10
L21 8JW,L21,8JW,58,26,32,25
L21 8JX,L21,8JX,32,17,15,24
L21 8JY,L21,8JY,47,28,19,25
L21 8JZ,L21,8JZ,38,20,18,23
L21 8LA,L21,8LA,81,43,38,39
L21 8LB,L21,8LB,50,23,27,30
L21 8LD,L21,8LD,8,5,3,6
L21 8LF,L21,8LF,32,20,12,18
L21 8LH,L21,8LH,35,18,17,24
L21 8LL,L21,8LL,92,52,40,42
L21 8LN,L21,8LN,41,19,22,15
L21 8LP,L21,8LP,75,37,38,51
L21 8LQ,L21,8LQ,19,10,9,7
L21 8LS,L21,8LS,112,45,67,53
L21 8LU,L21,8LU,41,17,24,13
L21 8LW,L21,8LW,54,29,25,18
L21 8LY,L21,8LY,44,22,22,22
L21 8LZ,L21,8LZ,43,21,22,13
L21 8NA,L21,8NA,83,39,44,35
L21 8NB,L21,8NB,99,55,44,35
L21 8ND,L21,8ND,66,37,29,30
L21 8NE,L21,8NE,21,11,10,10
L21 8NF,L21,8NF,60,29,31,22
L21 8NG,L21,8NG,27,10,17,11
L21 8NH,L21,8NH,56,27,29,21
L21 8NJ,L21,8NJ,18,8,10,8
L21 8NP,L21,8NP,8,5,3,3
L21 8NQ,L21,8NQ,22,12,10,6
L21 8NR,L21,8NR,12,7,5,7
L21 8NS,L21,8NS,9,6,3,6
L21 8NT,L21,8NT,13,10,3,5
L21 8NU,L21,8NU,21,10,11,6
L21 8NW,L21,8NW,46,22,24,20
L21 8PA,L21,8PA,64,33,31,21
L21 8PB,L21,8PB,48,21,27,18
L21 8PD,L21,8PD,58,28,30,24
L21 8PE,L21,8PE,83,42,41,26
L21 8PF,L21,8PF,17,10,7,7
L21 8PG,L21,8PG,39,18,21,24
L21 8PH,L21,8PH,46,24,22,19
L21 8PJ,L21,8PJ,5,3,2,2
L21 8PN,L21,8PN,42,17,25,22
L21 8PP,L21,8PP,33,19,14,27
L21 8PQ,L21,8PQ,15,6,9,8
L21 8PR,L21,8PR,20,10,10,6
L21 8PS,L21,8PS,54,24,30,19
L21 8PT,L21,8PT,43,18,25,17
L21 8PW,L21,8PW,29,15,14,9
L21 8QB,L21,8QB,20,9,11,8
L21 8QE,L21,8QE,25,15,10,19
L21 8QG,L21,8QG,36,16,20,12
L21 8QP,L21,8QP,16,8,8,6
L21 8QR,L21,8QR,12,6,6,5
L21 8QW,L21,8QW,23,11,12,8
L21 9HA,L21,9HA,57,28,29,19
L21 9HD,L21,9HD,11,7,4,4
L21 9HE,L21,9HE,5,2,3,4
L21 9HF,L21,9HF,9,7,2,4
L21 9HG,L21,9HG,31,11,20,12
L21 9HH,L21,9HH,49,20,29,17
L21 9HL,L21,9HL,92,38,54,40
L21 9HN,L21,9HN,86,38,48,35
L21 9HP,L21,9HP,143,81,62,56
L21 9HQ,L21,9HQ,45,23,22,16
L21 9HR,L21,9HR,109,60,49,46
L21 9HT,L21,9HT,125,60,65,47
L21 9HU,L21,9HU,72,31,41,29
L21 9HW,L21,9HW,135,65,70,43
L21 9HX,L21,9HX,127,56,71,41
L21 9HY,L21,9HY,51,24,27,19
L21 9HZ,L21,9HZ,20,8,12,9
L21 9JA,L21,9JA,36,16,20,18
L21 9JB,L21,9JB,12,5,7,4
L21 9JD,L21,9JD,49,20,29,28
L21 9JE,L21,9JE,63,30,33,22
L21 9JF,L21,9JF,83,37,46,32
L21 9JG,L21,9JG,71,34,37,27
L21 9JH,L21,9JH,29,15,14,14
L21 9JJ,L21,9JJ,64,32,32,24
L21 9JL,L21,9JL,9,5,4,3
L21 9JN,L21,9JN,119,58,61,48
L21 9JP,L21,9JP,30,13,17,10
L21 9JQ,L21,9JQ,56,24,32,24
L21 9JR,L21,9JR,92,45,47,32
L21 9JS,L21,9JS,90,43,47,36
L21 9JT,L21,9JT,82,45,37,29
L21 9JU,L21,9JU,83,37,46,31
L21 9JW,L21,9JW,52,21,31,18
L21 9JX,L21,9JX,50,25,25,17
L21 9JY,L21,9JY,74,36,38,31
L21 9JZ,L21,9JZ,58,22,36,23
L21 9LA,L21,9LA,36,17,19,13
L21 9LB,L21,9LB,50,23,27,18
L21 9LD,L21,9LD,85,41,44,29
L21 9LE,L21,9LE,47,24,23,24
L21 9LF,L21,9LF,55,27,28,22
L21 9LG,L21,9LG,24,9,15,8
L21 9LH,L21,9LH,114,58,56,39
L21 9LJ,L21,9LJ,70,30,40,26
L21 9LL,L21,9LL,50,25,25,17
L21 9LN,L21,9LN,75,39,36,31
L21 9LP,L21,9LP,49,23,26,21
L21 9LQ,L21,9LQ,74,34,40,28
L21 9LR,L21,9LR,80,38,42,31
L21 9LS,L21,9LS,46,22,24,35
L21 9LU,L21,9LU,25,11,14,12
L21 9LW,L21,9LW,35,20,15,17
L21 9LX,L21,9LX,5,4,1,4
L21 9LY,L21,9LY,81,33,48,26
L21 9NB,L21,9NB,12,7,5,7
L21 9NE,L21,9NE,29,14,15,13
L21 9NF,L21,9NF,21,9,12,7
L21 9NG,L21,9NG,36,13,23,18
L21 9NH,L21,9NH,49,25,24,26
L21 9NJ,L21,9NJ,30,16,14,14
L21 9NL,L21,9NL,49,19,30,20
L21 9NN,L21,9NN,63,31,32,28
L21 9NP,L21,9NP,53,23,30,24
L21 9NQ,L21,9NQ,25,15,10,19
L21 9NR,L21,9NR,42,18,24,17
L21 9NS,L21,9NS,41,18,23,16
L21 9NT,L21,9NT,19,6,13,11
L21 9NU,L21,9NU,139,63,76,53
L21 9NW,L21,9NW,92,44,48,37
L21 9NX,L21,9NX,91,44,47,36
L21 9NY,L21,9NY,82,41,41,31
L21 9NZ,L21,9NZ,8,5,3,6
L21 9PA,L21,9PA,52,26,26,20
L21 9PE,L21,9PE,46,22,24,19
L21 9PF,L21,9PF,52,21,31,44
L21 9PH,L21,9PH,78,38,40,65
L21 9PJ,L21,9PJ,45,16,29,40
L21 9PL,L21,9PL,24,10,14,9
L21 9PR,L21,9PR,19,8,11,9
L21 9PY,L21,9PY,77,36,41,30
L21 9PZ,L21,9PZ,34,18,16,14
L21 9QA,L21,9QA,43,22,21,19
L21 9QB,L21,9QB,46,22,24,20
L21 9QD,L21,9QD,21,7,14,10
L21 9QE,L21,9QE,56,32,24,40
L21 9QF,L21,9QF,64,32,32,21
L21 9QH,L21,9QH,17,12,5,11
L21 9QQ,L21,9QQ,55,27,28,33
L22 0LA,L22,0LA,6,3,3,2
L22 0LD,L22,0LD,1,1,0,1
L22 0LL,L22,0LL,110,54,56,39
L22 0LN,L22,0LN,62,30,32,27
L22 0LP,L22,0LP,33,17,16,9
L22 0LR,L22,0LR,15,7,8,9
L22 0LT,L22,0LT,20,9,11,10
L22 0LW,L22,0LW,48,24,24,21
L22 0ND,L22,0ND,5,4,1,4
L22 0NH,L22,0NH,51,29,22,30
L22 0NJ,L22,0NJ,88,51,37,31
L22 0NL,L22,0NL,79,38,41,34
L22 0NN,L22,0NN,72,37,35,26
L22 0NP,L22,0NP,74,36,38,30
L22 0NQ,L22,0NQ,25,12,13,15
L22 0NR,L22,0NR,41,23,18,19
L22 0NS,L22,0NS,132,77,55,74
L22 0NT,L22,0NT,115,56,59,41
L22 0NU,L22,0NU,86,51,35,43
L22 0NW,L22,0NW,63,27,36,28
L22 0NX,L22,0NX,47,21,26,19
L22 0QH,L22,0QH,2,1,1,1
L22 1RA,L22,1RA,35,18,17,21
L22 1RD,L22,1RD,70,32,38,35
L22 1RE,L22,1RE,37,20,17,24
L22 1RF,L22,1RF,111,57,54,54
L22 1RG,L22,1RG,22,10,12,11
L22 1RH,L22,1RH,20,7,13,9
L22 1RJ,L22,1RJ,87,48,39,49
L22 1RN,L22,1RN,27,16,11,8
L22 1RP,L22,1RP,136,57,79,84
L22 1RQ,L22,1RQ,19,11,8,12
L22 1RR,L22,1RR,120,57,63,48
L22 1RS,L22,1RS,52,31,21,24
L22 1RT,L22,1RT,77,34,43,28
L22 1RW,L22,1RW,109,51,58,42
L22 1SW,L22,1SW,39,20,19,22
L22 2AD,L22,2AD,62,24,38,31
L22 2AE,L22,2AE,52,22,30,24
L22 2AF,L22,2AF,49,24,25,22
L22 2AG,L22,2AG,66,34,32,28
L22 2AH,L22,2AH,19,6,13,9
L22 2AJ,L22,2AJ,114,53,61,43
L22 2AL,L22,2AL,56,26,30,26
L22 2AN,L22,2AN,68,35,33,33
L22 2AP,L22,2AP,104,49,55,39
L22 2AQ,L22,2AQ,70,34,36,28
L22 2AR,L22,2AR,77,36,41,33
L22 2AS,L22,2AS,71,31,40,28
L22 2AT,L22,2AT,91,45,46,38
L22 2AU,L22,2AU,51,23,28,27
L22 2AW,L22,2AW,74,38,36,32
L22 2AX,L22,2AX,63,31,32,27
L22 2AY,L22,2AY,68,31,37,24
L22 2AZ,L22,2AZ,112,52,60,40
L22 2BA,L22,2BA,65,34,31,26
L22 2BB,L22,2BB,49,21,28,24
L22 2BD,L22,2BD,61,32,29,25
L22 2BE,L22,2BE,32,13,19,14
L22 2BH,L22,2BH,125,51,74,46
L22 2BJ,L22,2BJ,93,46,47,41
L22 2BP,L22,2BP,4,1,3,1
L22 2BQ,L22,2BQ,76,33,43,30
L22 2BR,L22,2BR,18,8,10,13
L22 3RB,L22,3RB,4,1,3,2
L22 3XA,L22,3XA,53,28,25,35
L22 3XB,L22,3XB,38,15,23,20
L22 3XD,L22,3XD,16,8,8,8
L22 3XE,L22,3XE,49,33,16,38
L22 3XF,L22,3XF,8,5,3,4
L22 3XG,L22,3XG,110,44,66,19
L22 3XH,L22,3XH,50,25,25,19
L22 3XJ,L22,3XJ,19,9,10,10
L22 3XL,L22,3XL,13,5,8,10
L22 3XN,L22,3XN,57,28,29,23
L22 3XP,L22,3XP,6,3,3,3
L22 3XQ,L22,3XQ,23,11,12,14
L22 3XS,L22,3XS,12,0,12,0
L22 3XT,L22,3XT,31,14,17,13
L22 3XU,L22,3XU,74,36,38,35
L22 3XX,L22,3XX,36,18,18,13
L22 3XY,L22,3XY,64,30,34,24
L22 3XZ,L22,3XZ,67,31,36,29
L22 3YA,L22,3YA,105,55,50,40
L22 3YB,L22,3YB,97,48,49,34
L22 3YD,L22,3YD,120,52,68,50
L22 3YE,L22,3YE,92,46,46,35
L22 3YF,L22,3YF,43,19,24,21
L22 3YG,L22,3YG,20,7,13,16
L22 3YH,L22,3YH,24,10,14,12
L22 3YR,L22,3YR,48,25,23,16
L22 3YU,L22,3YU,23,11,12,8
L22 3YX,L22,3YX,76,40,36,27
L22 4QA,L22,4QA,58,24,34,27
L22 4QD,L22,4QD,6,3,3,2
L22 4QJ,L22,4QJ,89,47,42,30
L22 4QL,L22,4QL,85,44,41,34
L22 4QN,L22,4QN,75,39,36,27
L22 4QP,L22,4QP,121,59,62,40
L22 4QR,L22,4QR,19,8,11,9
L22 4QS,L22,4QS,39,16,23,12
L22 4QT,L22,4QT,71,37,34,25
L22 4QU,L22,4QU,4,2,2,3
L22 4QW,L22,4QW,68,31,37,19
L22 4QX,L22,4QX,116,56,60,44
L22 4QY,L22,4QY,104,49,55,45
L22 4QZ,L22,4QZ,107,53,54,42
L22 4RA,L22,4RA,119,61,58,41
L22 4RB,L22,4RB,61,24,37,28
L22 4RD,L22,4RD,69,36,33,24
L22 4RE,L22,4RE,138,69,69,46
L22 4RF,L22,4RF,114,52,62,43
L22 4RG,L22,4RG,71,35,36,30
L22 4RH,L22,4RH,68,36,32,29
L22 4RJ,L22,4RJ,82,36,46,33
L22 4RL,L22,4RL,101,47,54,45
L22 4RN,L22,4RN,155,79,76,50
L22 4RQ,L22,4RQ,88,44,44,29
L22 4RS,L22,4RS,109,54,55,44
L22 5BD,L22,5BD,24,13,11,15
L22 5NA,L22,5NA,36,19,17,21
L22 5NB,L22,5NB,5,4,1,4
L22 5ND,L22,5ND,19,9,10,7
L22 5NG,L22,5NG,7,4,3,4
L22 5NL,L22,5NL,54,26,28,32
L22 5NN,L22,5NN,58,26,32,23
L22 5NP,L22,5NP,22,11,11,8
L22 5NR,L22,5NR,3,2,1,2
L22 5NS,L22,5NS,76,36,40,29
L22 5NT,L22,5NT,63,33,30,31
L22 5NU,L22,5NU,5,3,2,3
L22 5NW,L22,5NW,85,44,41,32
L22 5NY,L22,5NY,12,8,4,4
L22 5NZ,L22,5NZ,33,18,15,17
L22 5PA,L22,5PA,14,6,8,7
L22 5PB,L22,5PB,39,18,21,20
L22 5PD,L22,5PD,37,15,22,16
L22 5PE,L22,5PE,10,7,3,9
L22 5PL,L22,5PL,80,52,28,45
L22 5PQ,L22,5PQ,42,28,14,28
L22 5PR,L22,5PR,56,37,19,20
L22 5PS,L22,5PS,24,14,10,8
L22 5PT,L22,5PT,50,30,20,23
L22 5PU,L22,5PU,4,0,4,4
L22 5PW,L22,5PW,38,23,15,25
L22 5PX,L22,5PX,41,26,15,27
L22 5PY,L22,5PY,59,32,27,35
L22 5PZ,L22,5PZ,9,3,6,7
L22 5QA,L22,5QA,74,46,28,53
L22 5QD,L22,5QD,64,48,16,57
L22 5QH,L22,5QH,15,6,9,8
L22 5QJ,L22,5QJ,8,5,3,8
L22 5QN,L22,5QN,17,11,6,12
L22 5QT,L22,5QT,15,6,9,12
L22 5QU,L22,5QU,31,17,14,17
L22 5QW,L22,5QW,60,30,30,33
L22 5QX,L22,5QX,19,11,8,8
L22 5RN,L22,5RN,27,16,11,20
L22 6QA,L22,6QA,37,17,20,14
L22 6QB,L22,6QB,64,34,30,28
L22 6QE,L22,6QE,53,28,25,25
L22 6QF,L22,6QF,59,31,28,33
L22 6QG,L22,6QG,59,27,32,24
L22 6QH,L22,6QH,10,3,7,8
L22 6QJ,L22,6QJ,24,11,13,11
L22 6QL,L22,6QL,22,13,9,10
L22 6QN,L22,6QN,48,27,21,24
L22 6QP,L22,6QP,50,25,25,28
L22 6QQ,L22,6QQ,62,27,35,24
L22 6QR,L22,6QR,80,40,40,40
L22 6QS,L22,6QS,71,31,40,33
L22 6QT,L22,6QT,57,27,30,31
L22 6QU,L22,6QU,91,49,42,36
L22 6QW,L22,6QW,48,19,29,18
L22 6QX,L22,6QX,29,10,19,17
L22 6QY,L22,6QY,74,33,41,31
L22 6QZ,L22,6QZ,73,37,36,28
L22 6RA,L22,6RA,39,18,21,20
L22 6RB,L22,6RB,30,15,15,12
L22 6RD,L22,6RD,13,8,5,8
L22 6RE,L22,6RE,81,45,36,28
L22 6RF,L22,6RF,75,37,38,27
L22 6RQ,L22,6RQ,7,4,3,3
L22 7RA,L22,7RA,93,57,36,57
L22 7RB,L22,7RB,24,13,11,8
L22 7RD,L22,7RD,87,44,43,35
L22 7RE,L22,7RE,43,19,24,17
L22 7RF,L22,7RF,31,14,17,10
L22 7RG,L22,7RG,60,32,28,25
L22 7RH,L22,7RH,105,50,55,45
L22 7RJ,L22,7RJ,17,7,10,8
L22 7RL,L22,7RL,30,19,11,16
L22 7RN,L22,7RN,66,35,31,25
L22 7RP,L22,7RP,99,49,50,40
L22 7RQ,L22,7RQ,73,36,37,27
L22 7RR,L22,7RR,23,10,13,8
L22 7RS,L22,7RS,21,11,10,10
L22 7RT,L22,7RT,35,12,23,20
L22 7RU,L22,7RU,30,13,17,15
L22 7RW,L22,7RW,115,63,52,54
L22 7RX,L22,7RX,32,15,17,14
L22 7RY,L22,7RY,77,42,35,29
L22 7RZ,L22,7RZ,70,40,30,28
L22 7SA,L22,7SA,29,14,15,14
L22 7SG,L22,7SG,26,10,16,18
L22 8QA,L22,8QA,87,30,57,30
L22 8QB,L22,8QB,72,42,30,26
L22 8QD,L22,8QD,67,39,28,29
L22 8QE,L22,8QE,109,57,52,46
L22 8QF,L22,8QF,84,47,37,47
L22 8QG,L22,8QG,132,65,67,50
L22 8QH,L22,8QH,67,37,30,27
L22 8QJ,L22,8QJ,6,2,4,5
L22 8QL,L22,8QL,63,34,29,32
L22 8QN,L22,8QN,63,32,31,30
L22 8QP,L22,8QP,75,36,39,35
L22 8QQ,L22,8QQ,12,6,6,4
L22 8QR,L22,8QR,58,27,31,35
L22 8QS,L22,8QS,48,18,30,22
L22 8QT,L22,8QT,88,40,48,40
L22 8QU,L22,8QU,17,7,10,7
L22 8QW,L22,8QW,7,3,4,4
L22 8QX,L22,8QX,5,1,4,3
L22 8QY,L22,8QY,36,17,19,30
L22 8QZ,L22,8QZ,48,13,35,42
L22 8RA,L22,8RA,12,5,7,6
L22 8RD,L22,8RD,1,1,0,1
L22 8RH,L22,8RH,12,7,5,6
L22 9QA,L22,9QA,13,4,9,10
L22 9QB,L22,9QB,24,14,10,15
L22 9QD,L22,9QD,18,12,6,12
L22 9QE,L22,9QE,24,11,13,12
L22 9QG,L22,9QG,35,18,17,20
L22 9QH,L22,9QH,101,51,50,41
L22 9QJ,L22,9QJ,95,43,52,39
L22 9QL,L22,9QL,127,67,60,41
L22 9QN,L22,9QN,70,30,40,27
L22 9QP,L22,9QP,76,25,51,28
L22 9QQ,L22,9QQ,30,16,14,13
L22 9QR,L22,9QR,91,46,45,27
L22 9QS,L22,9QS,118,54,64,46
L22 9QT,L22,9QT,83,40,43,25
L22 9QU,L22,9QU,63,28,35,25
L22 9QW,L22,9QW,69,33,36,27
L22 9QX,L22,9QX,127,64,63,51
L22 9QY,L22,9QY,68,38,30,31
L22 9QZ,L22,9QZ,58,30,28,26
L22 9RD,L22,9RD,24,8,16,14
L22 9RG,L22,9RG,78,40,38,40
L22 9RH,L22,9RH,36,18,18,34
L23 0QA,L23,0QA,39,16,23,19
L23 0QB,L23,0QB,78,39,39,26
L23 0QD,L23,0QD,84,41,43,30
L23 0QE,L23,0QE,38,15,23,14
L23 0QF,L23,0QF,45,24,21,15
L23 0QG,L23,0QG,50,27,23,18
L23 0QH,L23,0QH,36,17,19,15
L23 0QJ,L23,0QJ,58,28,30,20
L23 0QL,L23,0QL,53,32,21,20
L23 0QN,L23,0QN,26,15,11,11
L23 0QQ,L23,0QQ,47,23,24,19
L23 0QR,L23,0QR,50,20,30,16
L23 0QS,L23,0QS,39,16,23,15
L23 0QT,L23,0QT,52,6,46,0
L23 0QU,L23,0QU,27,12,15,10
L23 0QW,L23,0QW,22,13,9,11
L23 0QX,L23,0QX,55,19,36,26
L23 0QZ,L23,0QZ,71,39,32,30
L23 0RA,L23,0RA,44,19,25,17
L23 0RB,L23,0RB,53,25,28,22
L23 0RD,L23,0RD,125,65,60,37
L23 0RE,L23,0RE,59,30,29,23
L23 0RF,L23,0RF,52,21,31,22
L23 0RG,L23,0RG,60,25,35,22
L23 0RH,L23,0RH,82,39,43,30
L23 0RJ,L23,0RJ,38,16,22,10
L23 0RL,L23,0RL,44,17,27,20
L23 0RN,L23,0RN,30,14,16,22
L23 0RP,L23,0RP,52,29,23,20
L23 0RQ,L23,0RQ,56,27,29,21
L23 0RS,L23,0RS,37,17,20,16
L23 0RT,L23,0RT,56,21,35,21
L23 0RU,L23,0RU,71,33,38,30
L23 0RW,L23,0RW,50,26,24,17
L23 0RX,L23,0RX,22,12,10,9
L23 0RY,L23,0RY,69,32,37,26
L23 0RZ,L23,0RZ,40,17,23,15
L23 0SA,L23,0SA,94,45,49,32
L23 0SB,L23,0SB,97,44,53,34
L23 0SD,L23,0SD,85,42,43,31
L23 0SE,L23,0SE,32,15,17,14
L23 0SF,L23,0SF,97,43,54,40
L23 0SG,L23,0SG,46,23,23,19
L23 0SH,L23,0SH,87,46,41,28
L23 0SJ,L23,0SJ,21,10,11,7
L23 0SL,L23,0SL,50,22,28,20
L23 0SN,L23,0SN,62,28,34,30
L23 0SP,L23,0SP,15,8,7,6
L23 0SQ,L23,0SQ,51,20,31,20
L23 0SR,L23,0SR,30,14,16,9
L23 0SS,L23,0SS,80,39,41,27
L23 0ST,L23,0ST,54,26,28,20
L23 0SU,L23,0SU,60,30,30,26
L23 0SW,L23,0SW,57,27,30,20
L23 0SX,L23,0SX,73,31,42,29
L23 0SY,L23,0SY,75,37,38,30
L23 0SZ,L23,0SZ,89,43,46,30
L23 0TA,L23,0TA,80,38,42,30
L23 0TB,L23,0TB,24,12,12,9
L23 0TD,L23,0TD,77,41,36,24
L23 0TE,L23,0TE,84,43,41,32
L23 0TF,L23,0TF,43,22,21,17
L23 0TG,L23,0TG,119,59,60,43
L23 0TH,L23,0TH,88,38,50,35
L23 0TJ,L23,0TJ,54,27,27,17
L23 0TL,L23,0TL,92,44,48,35
L23 0TN,L23,0TN,76,45,31,27
L23 0TP,L23,0TP,25,9,16,12
L23 0TQ,L23,0TQ,91,45,46,39
L23 0TR,L23,0TR,17,7,10,8
L23 0TT,L23,0TT,72,31,41,38
L23 0TU,L23,0TU,21,11,10,9
L23 0TW,L23,0TW,68,34,34,21
L23 0TX,L23,0TX,50,27,23,20
L23 0TY,L23,0TY,37,16,21,16
L23 0TZ,L23,0TZ,35,17,18,13
L23 0UB,L23,0UB,44,24,20,18
L23 0UE,L23,0UE,56,30,26,22
L23 0UF,L23,0UF,70,38,32,27
L23 0UG,L23,0UG,123,51,72,44
L23 0UH,L23,0UH,11,4,7,5
L23 0UJ,L23,0UJ,49,25,24,16
L23 0UL,L23,0UL,13,6,7,4
L23 0UN,L23,0UN,93,40,53,33
L23 0UQ,L23,0UQ,117,54,63,41
L23 0UR,L23,0UR,82,42,40,70
L23 0UT,L23,0UT,17,8,9,10
L23 0UW,L23,0UW,73,36,37,32
L23 0YD,L23,0YD,13,7,6,8
L23 0YE,L23,0YE,19,12,7,10
L23 1TA,L23,1TA,84,40,44,36
L23 1TB,L23,1TB,61,27,34,28
L23 1TD,L23,1TD,59,29,30,25
L23 1TE,L23,1TE,9,4,5,3
L23 1TG,L23,1TG,6,3,3,2
L23 1TH,L23,1TH,77,29,48,46
L23 1TJ,L23,1TJ,48,25,23,25
L23 1TL,L23,1TL,34,21,13,13
L23 1TN,L23,1TN,34,16,18,15
L23 1TP,L23,1TP,28,12,16,15
L23 1TQ,L23,1TQ,13,8,5,10
L23 1TR,L23,1TR,117,51,66,51
L23 1TS,L23,1TS,15,7,8,7
L23 1TY,L23,1TY,43,16,27,17
L23 1TZ,L23,1TZ,83,37,46,36
L23 1UA,L23,1UA,2,1,1,2
L23 1UB,L23,1UB,142,40,102,26
L23 1UE,L23,1UE,38,16,22,26
L23 1UF,L23,1UF,6,4,2,6
L23 1UH,L23,1UH,116,52,64,37
L23 1UJ,L23,1UJ,59,24,35,21
L23 1UP,L23,1UP,85,33,52,45
L23 1UR,L23,1UR,72,35,37,28
L23 1US,L23,1US,83,39,44,32
L23 1UT,L23,1UT,35,15,20,22
L23 1UW,L23,1UW,42,19,23,23
L23 1UY,L23,1UY,33,11,22,19
L23 1XB,L23,1XB,28,13,15,16
L23 1XD,L23,1XD,120,65,55,42
L23 1XE,L23,1XE,69,33,36,29
L23 1XF,L23,1XF,18,9,9,5
L23 1XG,L23,1XG,32,15,17,14
L23 1XH,L23,1XH,16,10,6,7
L23 1XJ,L23,1XJ,57,27,30,30
L23 1XL,L23,1XL,122,60,62,47
L23 1XQ,L23,1XQ,26,13,13,12
L23 1XS,L23,1XS,30,14,16,11
L23 1XT,L23,1XT,25,14,11,10
L23 1ZA,L23,1ZA,21,10,11,8
L23 1ZD,L23,1ZD,42,11,31,40
L23 2QY,L23,2QY,13,6,7,5
L23 2QZ,L23,2QZ,12,7,5,8
L23 2RA,L23,2RA,57,31,26,27
L23 2RB,L23,2RB,42,22,20,15
L23 2RD,L23,2RD,60,32,28,21
L23 2RE,L23,2RE,48,23,25,20
L23 2RF,L23,2RF,41,20,21,15
L23 2RG,L23,2RG,45,21,24,17
L23 2RH,L23,2RH,66,32,34,25
L23 2RJ,L23,2RJ,96,45,51,34
L23 2RL,L23,2RL,52,23,29,27
L23 2RN,L23,2RN,66,32,34,25
L23 2RP,L23,2RP,13,6,7,6
L23 2RQ,L23,2RQ,33,15,18,13
L23 2RR,L23,2RR,57,31,26,21
L23 2RS,L23,2RS,26,13,13,8
L23 2RT,L23,2RT,34,17,17,17
L23 2RU,L23,2RU,25,13,12,10
L23 2RW,L23,2RW,55,26,29,22
L23 2RX,L23,2RX,3,2,1,1
L23 2RY,L23,2RY,57,31,26,23
L23 2RZ,L23,2RZ,103,49,54,43
L23 2SD,L23,2SD,42,21,21,31
L23 2SE,L23,2SE,3,2,1,1
L23 2SF,L23,2SF,9,3,6,4
L23 2SG,L23,2SG,30,16,14,11
L23 2SH,L23,2SH,68,24,44,10
L23 2SJ,L23,2SJ,19,8,11,11
L23 2SL,L23,2SL,18,10,8,9
L23 2SN,L23,2SN,49,21,28,19
L23 2SP,L23,2SP,56,28,28,23
L23 2SQ,L23,2SQ,7,2,5,3
L23 2SR,L23,2SR,43,22,21,17
L23 2SS,L23,2SS,71,32,39,27
L23 2ST,L23,2ST,32,13,19,16
L23 2SU,L23,2SU,32,13,19,13
L23 2SW,L23,2SW,83,39,44,30
L23 2SX,L23,2SX,24,12,12,9
L23 2SY,L23,2SY,30,15,15,10
L23 2SZ,L23,2SZ,57,28,29,21
L23 2TA,L23,2TA,17,8,9,7
L23 2TB,L23,2TB,7,5,2,3
L23 2TE,L23,2TE,22,8,14,11
L23 2TF,L23,2TF,31,12,19,9
L23 2TG,L23,2TG,13,8,5,5
L23 2TH,L23,2TH,78,41,37,26
L23 2TJ,L23,2TJ,73,31,42,28
L23 2TL,L23,2TL,79,42,37,32
L23 2TN,L23,2TN,82,39,43,32
L23 2TP,L23,2TP,60,26,34,23
L23 2TQ,L23,2TQ,22,11,11,8
L23 2TR,L23,2TR,64,35,29,21
L23 2TS,L23,2TS,57,31,26,20
L23 2TT,L23,2TT,69,41,28,38
L23 2TU,L23,2TU,5,2,3,5
L23 2TW,L23,2TW,72,37,35,27
L23 2TX,L23,2TX,36,18,18,15
L23 2TY,L23,2TY,84,44,40,41
L23 2TZ,L23,2TZ,36,12,24,10
L23 2UA,L23,2UA,110,53,57,42
L23 2UB,L23,2UB,47,23,24,20
L23 2UD,L23,2UD,29,12,17,11
L23 2UE,L23,2UE,18,9,9,8
L23 2UF,L23,2UF,46,17,29,20
L23 2UH,L23,2UH,49,20,29,18
L23 2UL,L23,2UL,34,17,17,12
L23 2UN,L23,2UN,2,1,1,2
L23 2UP,L23,2UP,101,46,55,35
L23 2UQ,L23,2UQ,58,30,28,22
L23 2UR,L23,2UR,68,34,34,26
L23 2US,L23,2US,57,23,34,24
L23 2UT,L23,2UT,73,36,37,29
L23 2UU,L23,2UU,58,32,26,21
L23 2UX,L23,2UX,69,35,34,25
L23 2UY,L23,2UY,83,39,44,28
L23 2UZ,L23,2UZ,66,31,35,20
L23 2XA,L23,2XA,38,15,23,25
L23 2XB,L23,2XB,26,13,13,8
L23 2XD,L23,2XD,32,13,19,11
L23 2XF,L23,2XF,83,41,42,57
L23 2XH,L23,2XH,97,46,51,39
L23 2XJ,L23,2XJ,28,15,13,11
L23 2XN,L23,2XN,22,12,10,8
L23 2XQ,L23,2XQ,12,4,8,11
L23 2XT,L23,2XT,26,11,15,10
L23 2YR,L23,2YR,8,6,2,5
L23 2YW,L23,2YW,6,4,2,2
L23 3AD,L23,3AD,75,35,40,28
L23 3AE,L23,3AE,33,16,17,13
L23 3AG,L23,3AG,40,24,16,15
L23 3AH,L23,3AH,22,11,11,9
L23 3AJ,L23,3AJ,56,32,24,22
L23 3AL,L23,3AL,22,13,9,8
L23 3AN,L23,3AN,107,57,50,41
L23 3AP,L23,3AP,106,48,58,38
L23 3AQ,L23,3AQ,26,15,11,17
L23 3AR,L23,3AR,73,33,40,24
L23 3AS,L23,3AS,19,9,10,10
L23 3AT,L23,3AT,3,2,1,2
L23 3AW,L23,3AW,93,48,45,37
L23 3AX,L23,3AX,13,8,5,5
L23 3AY,L23,3AY,74,37,37,33
L23 3AZ,L23,3AZ,78,31,47,36
L23 3BA,L23,3BA,53,18,35,26
L23 3BB,L23,3BB,94,41,53,49
L23 3BD,L23,3BD,47,21,26,30
L23 3BE,L23,3BE,62,23,39,34
L23 3BG,L23,3BG,53,17,36,27
L23 3BJ,L23,3BJ,5,2,3,3
L23 3BN,L23,3BN,84,39,45,31
L23 3BP,L23,3BP,82,41,41,35
L23 3BQ,L23,3BQ,74,27,47,35
L23 3BR,L23,3BR,4,2,2,2
L23 3BS,L23,3BS,93,45,48,39
L23 3BT,L23,3BT,46,20,26,13
L23 3BU,L23,3BU,40,19,21,18
L23 3BW,L23,3BW,62,23,39,28
L23 3BX,L23,3BX,43,25,18,17
L23 3BY,L23,3BY,33,18,15,13
L23 3BZ,L23,3BZ,63,34,29,23
L23 3DA,L23,3DA,25,9,16,8
L23 3DB,L23,3DB,23,13,10,9
L23 3DD,L23,3DD,76,36,40,24
L23 3DE,L23,3DE,87,46,41,37
L23 3DF,L23,3DF,58,24,34,25
L23 3DG,L23,3DG,51,22,29,22
L23 3DH,L23,3DH,62,29,33,24
L23 3DJ,L23,3DJ,46,21,25,18
L23 3DL,L23,3DL,27,12,15,10
L23 3DN,L23,3DN,61,27,34,23
L23 3DP,L23,3DP,21,12,9,9
L23 3DQ,L23,3DQ,65,32,33,24
L23 3DR,L23,3DR,31,13,18,20
L23 3DS,L23,3DS,35,21,14,19
L23 3DW,L23,3DW,77,33,44,23
L23 4TA,L23,4TA,9,4,5,5
L23 4TB,L23,4TB,40,21,19,18
L23 4TD,L23,4TD,59,28,31,20
L23 4TE,L23,4TE,31,18,13,12
L23 4TF,L23,4TF,35,16,19,18
L23 4TG,L23,4TG,22,9,13,15
L23 4TH,L23,4TH,88,52,36,35
L23 4TJ,L23,4TJ,52,21,31,22
L23 4TL,L23,4TL,25,13,12,11
L23 4TP,L23,4TP,20,8,12,14
L23 4TQ,L23,4TQ,16,7,9,6
L23 4TR,L23,4TR,32,20,12,20
L23 4TS,L23,4TS,70,42,28,30
L23 4TT,L23,4TT,9,3,6,4
L23 4TU,L23,4TU,49,26,23,22
L23 4TW,L23,4TW,91,43,48,32
L23 4TX,L23,4TX,19,10,9,7
L23 4TY,L23,4TY,72,34,38,29
L23 4TZ,L23,4TZ,52,23,29,19
L23 4UA,L23,4UA,32,15,17,9
L23 4UB,L23,4UB,19,10,9,7
L23 4UD,L23,4UD,23,12,11,9
L23 4UE,L23,4UE,30,15,15,14
L23 4UF,L23,4UF,107,57,50,42
L23 4UG,L23,4UG,10,5,5,5
L23 4UH,L23,4UH,34,17,17,17
L23 4UJ,L23,4UJ,5,2,3,3
L23 4UN,L23,4UN,20,5,15,12
L23 4UQ,L23,4UQ,23,14,9,9
L23 5RB,L23,5RB,78,35,43,33
L23 5RD,L23,5RD,53,25,28,23
L23 5RE,L23,5RE,4,2,2,2
L23 5RL,L23,5RL,60,26,34,21
L23 5RN,L23,5RN,88,44,44,29
L23 5RP,L23,5RP,26,14,12,9
L23 5RQ,L23,5RQ,42,25,17,23
L23 5RR,L23,5RR,108,58,50,35
L23 5RS,L23,5RS,25,12,13,21
L23 5RT,L23,5RT,42,20,22,19
L23 5RU,L23,5RU,83,39,44,39
L23 5RW,L23,5RW,50,29,21,18
L23 5RX,L23,5RX,20,9,11,10
L23 5RY,L23,5RY,59,26,33,32
L23 5RZ,L23,5RZ,52,27,25,24
L23 5SA,L23,5SA,22,11,11,11
L23 5SD,L23,5SD,1,0,1,1
L23 5SE,L23,5SE,10,5,5,4
L23 5SR,L23,5SR,2,0,2,2
L23 5ST,L23,5ST,37,19,18,15
L23 5SU,L23,5SU,54,31,23,22
L23 5SX,L23,5SX,29,13,16,11
L23 5SY,L23,5SY,61,32,29,23
L23 5SZ,L23,5SZ,54,20,34,24
L23 5TA,L23,5TA,101,48,53,32
L23 5TB,L23,5TB,98,50,48,37
L23 5TD,L23,5TD,14,5,9,5
L23 5TE,L23,5TE,32,16,16,10
L23 5TG,L23,5TG,11,7,4,3
L23 5TH,L23,5TH,37,14,23,21
L23 5TJ,L23,5TJ,53,22,31,38
L23 5TL,L23,5TL,11,6,5,7
L23 5TN,L23,5TN,42,19,23,17
L23 5TP,L23,5TP,79,41,38,26
L23 5TR,L23,5TR,76,32,44,30
L23 5TS,L23,5TS,75,38,37,34
L23 5TT,L23,5TT,89,41,48,41
L23 5TU,L23,5TU,29,11,18,14
L23 5UJ,L23,5UJ,53,12,41,46
L23 6AB,L23,6AB,49,19,30,27
L23 6AD,L23,6AD,8,5,3,5
L23 6BA,L23,6BA,58,17,41,46
L23 6BD,L23,6BD,57,25,32,29
L23 6RA,L23,6RA,13,5,8,9
L23 6RJ,L23,6RJ,11,7,4,4
L23 6RN,L23,6RN,6,3,3,4
L23 6SA,L23,6SA,42,22,20,19
L23 6SG,L23,6SG,31,15,16,17
L23 6SN,L23,6SN,12,6,6,5
L23 6SP,L23,6SP,33,18,15,22
L23 6SR,L23,6SR,28,11,17,21
L23 6SS,L23,6SS,65,37,28,31
L23 6ST,L23,6ST,74,33,41,22
L23 6SU,L23,6SU,35,20,15,10
L23 6SW,L23,6SW,31,16,15,14
L23 6SX,L23,6SX,95,49,46,36
L23 6SY,L23,6SY,54,26,28,21
L23 6SZ,L23,6SZ,87,43,44,37
L23 6TA,L23,6TA,51,23,28,33
L23 6TB,L23,6TB,6,3,3,3
L23 6TD,L23,6TD,22,14,8,11
L23 6TE,L23,6TE,54,18,36,29
L23 6TF,L23,6TF,44,12,32,8
L23 6TH,L23,6TH,11,6,5,4
L23 6TJ,L23,6TJ,17,7,10,9
L23 6TL,L23,6TL,38,16,22,28
L23 6TN,L23,6TN,15,5,10,7
L23 6TP,L23,6TP,4,2,2,2
L23 6TQ,L23,6TQ,105,49,56,59
L23 6TR,L23,6TR,53,27,26,21
L23 6TS,L23,6TS,84,34,50,56
L23 6TT,L23,6TT,48,24,24,33
L23 6TU,L23,6TU,52,30,22,23
L23 6TW,L23,6TW,18,11,7,5
L23 6TX,L23,6TX,17,9,8,5
L23 6TY,L23,6TY,36,16,20,27
L23 6UA,L23,6UA,40,20,20,11
L23 6UB,L23,6UB,66,30,36,23
L23 6UE,L23,6UE,28,7,21,6
L23 6UF,L23,6UF,22,11,11,8
L23 6UG,L23,6UG,61,19,42,9
L23 6UH,L23,6UH,13,7,6,4
L23 6UJ,L23,6UJ,71,38,33,41
L23 6UL,L23,6UL,29,15,14,10
L23 6UN,L23,6UN,80,35,45,27
L23 6UP,L23,6UP,17,8,9,5
L23 6UQ,L23,6UQ,64,33,31,23
L23 6UR,L23,6UR,20,10,10,5
L23 6US,L23,6US,18,8,10,4
L23 6UT,L23,6UT,40,20,20,19
L23 6UU,L23,6UU,7,4,3,3
L23 6UW,L23,6UW,66,28,38,30
L23 6UX,L23,6UX,132,42,90,48
L23 6UY,L23,6UY,28,13,15,10
L23 6UZ,L23,6UZ,23,11,12,10
L23 6WD,L23,6WD,19,10,9,8
L23 6WE,L23,6WE,23,9,14,21
L23 6WG,L23,6WG,34,13,21,24
L23 6XA,L23,6XA,96,44,52,33
L23 6XB,L23,6XB,121,60,61,34
L23 6XD,L23,6XD,10,6,4,6
L23 6XE,L23,6XE,24,12,12,9
L23 6XG,L23,6XG,45,26,19,29
L23 6XH,L23,6XH,37,15,22,14
L23 6XJ,L23,6XJ,13,5,8,5
L23 6XN,L23,6XN,63,27,36,41
L23 6XP,L23,6XP,20,11,9,8
L23 6XQ,L23,6XQ,30,15,15,21
L23 6XR,L23,6XR,17,9,8,7
L23 6XS,L23,6XS,62,22,40,40
L23 6XT,L23,6XT,24,11,13,7
L23 6XU,L23,6XU,14,7,7,5
L23 6XW,L23,6XW,12,5,7,8
L23 6XX,L23,6XX,16,8,8,8
L23 6XY,L23,6XY,19,7,12,7
L23 6YD,L23,6YD,45,24,21,23
L23 7TA,L23,7TA,60,34,26,31
L23 7TB,L23,7TB,47,20,27,23
L23 7TD,L23,7TD,19,7,12,14
L23 7TE,L23,7TE,39,20,19,15
L23 7TF,L23,7TF,90,44,46,35
L23 7TG,L23,7TG,77,32,45,25
L23 7TH,L23,7TH,16,7,9,9
L23 7TJ,L23,7TJ,20,13,7,10
L23 7TL,L23,7TL,10,4,6,8
L23 7TN,L23,7TN,41,17,24,24
L23 7TP,L23,7TP,12,5,7,5
L23 7TR,L23,7TR,38,20,18,22
L23 7TS,L23,7TS,43,22,21,24
L23 7TU,L23,7TU,59,26,33,22
L23 7TW,L23,7TW,42,17,25,19
L23 7TX,L23,7TX,61,27,34,22
L23 7TY,L23,7TY,49,26,23,18
L23 7TZ,L23,7TZ,55,28,27,20
L23 7UA,L23,7UA,65,34,31,21
L23 7UB,L23,7UB,37,15,22,16
L23 7UD,L23,7UD,12,7,5,6
L23 7UE,L23,7UE,28,14,14,13
L23 7UF,L23,7UF,63,30,33,27
L23 7UG,L23,7UG,55,25,30,23
L23 7UH,L23,7UH,75,37,38,30
L23 7UJ,L23,7UJ,32,17,15,14
L23 7UL,L23,7UL,86,36,50,35
L23 7UN,L23,7UN,34,15,19,13
L23 7UP,L23,7UP,32,13,19,13
L23 7UQ,L23,7UQ,49,25,24,21
L23 7UR,L23,7UR,30,14,16,10
L23 7US,L23,7US,45,21,24,18
L23 7UT,L23,7UT,37,18,19,15
L23 7UU,L23,7UU,68,32,36,25
L23 7UW,L23,7UW,75,34,41,31
L23 7UX,L23,7UX,24,12,12,12
L23 7UY,L23,7UY,61,28,33,25
L23 7UZ,L23,7UZ,29,14,15,15
L23 7XA,L23,7XA,26,15,11,12
L23 7XB,L23,7XB,40,20,20,17
L23 7XD,L23,7XD,63,37,26,23
L23 7XE,L23,7XE,86,40,46,31
L23 7XF,L23,7XF,77,36,41,30
L23 7XG,L23,7XG,47,18,29,17
L23 7XH,L23,7XH,39,18,21,15
L23 7XJ,L23,7XJ,45,22,23,15
L23 7XL,L23,7XL,31,13,18,11
L23 7XN,L23,7XN,104,54,50,33
L23 7XS,L23,7XS,4,0,4,2
L23 7XT,L23,7XT,8,5,3,4
L23 7XU,L23,7XU,20,10,10,8
L23 7XW,L23,7XW,95,49,46,36
L23 7XX,L23,7XX,6,2,4,5
L23 7XY,L23,7XY,68,31,37,36
L23 7XZ,L23,7XZ,55,27,28,22
L23 7YA,L23,7YA,101,43,58,38
L23 7YB,L23,7YB,120,60,60,46
L23 7YD,L23,7YD,16,7,9,8
L23 7YE,L23,7YE,67,36,31,24
L23 7YF,L23,7YF,60,26,34,23
L23 7YG,L23,7YG,12,4,8,7
L23 7YH,L23,7YH,85,39,46,28
L23 7YJ,L23,7YJ,100,50,50,33
L23 7YQ,L23,7YQ,23,10,13,8
L23 7YX,L23,7YX,10,5,5,8
L23 8SA,L23,8SA,19,6,13,15
L23 8SB,L23,8SB,24,13,11,9
L23 8SD,L23,8SD,30,13,17,14
L23 8SE,L23,8SE,1,1,0,1
L23 8SF,L23,8SF,25,13,12,16
L23 8SG,L23,8SG,26,14,12,9
L23 8SH,L23,8SH,34,15,19,17
L23 8SJ,L23,8SJ,49,24,25,19
L23 8SL,L23,8SL,30,14,16,12
L23 8SN,L23,8SN,13,6,7,7
L23 8SP,L23,8SP,31,15,16,11
L23 8SQ,L23,8SQ,25,11,14,12
L23 8SR,L23,8SR,17,5,12,12
L23 8SS,L23,8SS,28,14,14,23
L23 8ST,L23,8ST,35,14,21,24
L23 8SU,L23,8SU,51,27,24,21
L23 8SW,L23,8SW,74,28,46,36
L23 8SX,L23,8SX,28,14,14,13
L23 8SY,L23,8SY,49,24,25,22
L23 8TA,L23,8TA,25,11,14,16
L23 8TB,L23,8TB,33,20,13,15
L23 8TD,L23,8TD,26,12,14,12
L23 8TE,L23,8TE,18,9,9,5
L23 8TF,L23,8TF,36,19,17,18
L23 8TG,L23,8TG,38,18,20,15
L23 8TH,L23,8TH,13,7,6,8
L23 8TL,L23,8TL,8,4,4,6
L23 8TN,L23,8TN,61,25,36,23
L23 8TP,L23,8TP,42,23,19,16
L23 8TQ,L23,8TQ,49,23,26,15
L23 8TR,L23,8TR,27,12,15,12
L23 8TS,L23,8TS,40,19,21,17
L23 8TT,L23,8TT,28,13,15,15
L23 8TU,L23,8TU,37,19,18,15
L23 8TW,L23,8TW,29,15,14,14
L23 8TX,L23,8TX,54,27,27,18
L23 8TY,L23,8TY,28,12,16,12
L23 8TZ,L23,8TZ,45,23,22,20
L23 8UA,L23,8UA,18,8,10,10
L23 8UB,L23,8UB,15,7,8,7
L23 8UD,L23,8UD,55,27,28,28
L23 8UE,L23,8UE,48,26,22,19
L23 8UF,L23,8UF,81,44,37,29
L23 8UG,L23,8UG,40,12,28,11
L23 8UH,L23,8UH,59,33,26,18
L23 8UJ,L23,8UJ,53,26,27,32
L23 8UL,L23,8UL,27,12,15,9
L23 8UN,L23,8UN,42,23,19,11
L23 8UP,L23,8UP,49,20,29,19
L23 8UQ,L23,8UQ,65,29,36,31
L23 8UR,L23,8UR,59,26,33,20
L23 8US,L23,8US,48,23,25,21
L23 8UT,L23,8UT,39,17,22,15
L23 8UU,L23,8UU,74,32,42,21
L23 8UW,L23,8UW,70,32,38,20
L23 8UX,L23,8UX,15,6,9,7
L23 8XB,L23,8XB,8,4,4,3
L23 8XN,L23,8XN,17,10,7,5
L23 9RU,L23,9RU,3,2,1,1
L23 9SA,L23,9SA,48,25,23,22
L23 9SB,L23,9SB,58,33,25,20
L23 9SD,L23,9SD,13,7,6,8
L23 9SE,L23,9SE,21,8,13,12
L23 9SF,L23,9SF,68,33,35,29
L23 9SG,L23,9SG,47,20,27,16
L23 9SH,L23,9SH,27,13,14,12
L23 9SJ,L23,9SJ,31,14,17,12
L23 9SL,L23,9SL,31,16,15,13
L23 9SN,L23,9SN,64,38,26,21
L23 9SP,L23,9SP,45,17,28,28
L23 9SQ,L23,9SQ,73,33,40,30
L23 9SR,L23,9SR,79,37,42,33
L23 9SS,L23,9SS,65,27,38,28
L23 9ST,L23,9ST,63,32,31,30
L23 9SU,L23,9SU,24,11,13,12
L23 9SW,L23,9SW,55,23,32,29
L23 9SX,L23,9SX,90,47,43,37
L23 9SY,L23,9SY,54,30,24,31
L23 9SZ,L23,9SZ,38,16,22,18
L23 9TA,L23,9TA,23,8,15,22
L23 9TB,L23,9TB,26,15,11,12
L23 9TD,L23,9TD,27,15,12,9
L23 9TE,L23,9TE,48,25,23,25
L23 9TF,L23,9TF,83,35,48,31
L23 9TG,L23,9TG,51,25,26,20
L23 9TH,L23,9TH,64,37,27,21
L23 9TJ,L23,9TJ,25,11,14,13
L23 9TL,L23,9TL,36,18,18,16
L23 9TN,L23,9TN,72,34,38,27
L23 9TP,L23,9TP,39,15,24,21
L23 9TQ,L23,9TQ,56,28,28,21
L23 9TR,L23,9TR,26,12,14,11
L23 9TS,L23,9TS,45,23,22,19
L23 9TT,L23,9TT,51,21,30,20
L23 9TU,L23,9TU,44,22,22,19
L23 9TW,L23,9TW,70,34,36,22
L23 9TX,L23,9TX,47,22,25,18
L23 9TY,L23,9TY,68,33,35,30
L23 9TZ,L23,9TZ,78,44,34,30
L23 9UA,L23,9UA,55,18,37,37
L23 9UB,L23,9UB,102,50,52,38
L23 9UD,L23,9UD,80,40,40,30
L23 9UE,L23,9UE,77,34,43,27
L23 9UF,L23,9UF,67,35,32,25
L23 9UG,L23,9UG,79,40,39,30
L23 9UH,L23,9UH,54,26,28,28
L23 9UJ,L23,9UJ,69,27,42,28
L23 9UL,L23,9UL,88,47,41,31
L23 9UN,L23,9UN,74,34,40,26
L23 9UP,L23,9UP,63,32,31,26
L23 9UQ,L23,9UQ,98,47,51,38
L23 9UR,L23,9UR,84,38,46,36
L23 9US,L23,9US,77,35,42,39
L23 9UT,L23,9UT,75,39,36,21
L23 9UU,L23,9UU,35,13,22,16
L23 9UW,L23,9UW,50,27,23,25
L23 9UX,L23,9UX,94,42,52,46
L23 9UY,L23,9UY,131,58,73,47
L23 9UZ,L23,9UZ,82,38,44,31
L23 9XA,L23,9XA,38,19,19,16
L23 9XB,L23,9XB,74,32,42,30
L23 9XD,L23,9XD,15,9,6,11
L23 9XE,L23,9XE,25,11,14,10
L23 9XF,L23,9XF,45,17,28,18
L23 9XG,L23,9XG,86,46,40,31
L23 9XH,L23,9XH,50,25,25,18
L23 9XJ,L23,9XJ,83,36,47,38
L23 9XL,L23,9XL,41,18,23,23
L23 9XP,L23,9XP,75,30,45,41
L23 9XQ,L23,9XQ,81,36,45,34
L23 9XR,L23,9XR,94,45,49,32
L23 9XS,L23,9XS,77,37,40,34
L23 9XU,L23,9XU,93,48,45,33
L23 9XW,L23,9XW,55,26,29,23
L23 9XX,L23,9XX,89,45,44,30
L23 9XY,L23,9XY,76,35,41,33
L23 9XZ,L23,9XZ,80,39,41,32
L23 9YF,L23,9YF,51,16,35,38
L23 9YG,L23,9YG,92,40,52,41
L23 9YH,L23,9YH,54,28,26,32
L23 9YJ,L23,9YJ,50,27,23,15
L23 9YL,L23,9YL,16,7,9,7
L23 9YN,L23,9YN,25,12,13,10
L23 9YP,L23,9YP,35,18,17,15
L23 9YQ,L23,9YQ,64,28,36,52
L23 9YR,L23,9YR,134,58,76,49
L23 9YT,L23,9YT,11,4,7,4
L23 9YU,L23,9YU,62,29,33,23
L23 9YW,L23,9YW,156,75,81,59
L24 0SA,L24,0SA,105,53,52,45
L24 0SB,L24,0SB,84,35,49,37
L24 0SD,L24,0SD,103,48,55,38
L24 0SE,L24,0SE,60,20,40,23
L24 0SF,L24,0SF,59,25,34,24
L24 0SG,L24,0SG,53,26,27,20
L24 0SH,L24,0SH,77,38,39,29
L24 0SJ,L24,0SJ,109,49,60,33
L24 0SL,L24,0SL,64,29,35,29
L24 0SN,L24,0SN,114,53,61,44
L24 0SP,L24,0SP,103,51,52,47
L24 0SQ,L24,0SQ,47,23,24,24
L24 0SR,L24,0SR,34,15,19,17
L24 0SS,L24,0SS,42,13,29,18
L24 0ST,L24,0ST,86,41,45,35
L24 0SU,L24,0SU,64,29,35,24
L24 0SW,L24,0SW,124,65,59,49
L24 0SX,L24,0SX,86,36,50,24
L24 0SY,L24,0SY,58,26,32,26
L24 0SZ,L24,0SZ,68,27,41,30
L24 0TA,L24,0TA,64,28,36,34
L24 0TB,L24,0TB,37,17,20,15
L24 0TD,L24,0TD,95,47,48,35
L24 0TE,L24,0TE,90,41,49,40
L24 0TF,L24,0TF,45,18,27,16
L24 0TG,L24,0TG,40,17,23,19
L24 0TH,L24,0TH,58,28,30,23
L24 0TJ,L24,0TJ,72,32,40,28
L24 0TL,L24,0TL,50,22,28,36
L24 0TP,L24,0TP,33,18,15,16
L24 0TQ,L24,0TQ,70,36,34,30
L24 0TR,L24,0TR,74,29,45,35
L24 0TS,L24,0TS,34,15,19,15
L24 1UA,L24,1UA,46,18,28,16
L24 1UB,L24,1UB,16,10,6,16
L24 1UD,L24,1UD,47,22,25,21
L24 1UE,L24,1UE,84,44,40,35
L24 1UF,L24,1UF,65,33,32,23
L24 1UG,L24,1UG,7,3,4,5
L24 1UH,L24,1UH,106,52,54,39
L24 1UJ,L24,1UJ,83,41,42,39
L24 1UL,L24,1UL,68,32,36,33
L24 1UN,L24,1UN,100,47,53,45
L24 1UP,L24,1UP,48,25,23,20
L24 1UR,L24,1UR,19,11,8,8
L24 1US,L24,1US,104,51,53,35
L24 1UW,L24,1UW,67,30,37,22
L24 1XD,L24,1XD,7,2,5,4
L24 1XG,L24,1XG,91,45,46,35
L24 1XH,L24,1XH,15,7,8,7
L24 1XJ,L24,1XJ,35,15,20,12
L24 1XL,L24,1XL,49,20,29,14
L24 1XN,L24,1XN,13,6,7,4
L24 1XP,L24,1XP,30,11,19,10
L24 1XQ,L24,1XQ,76,34,42,30
L24 1XR,L24,1XR,41,27,14,18
L24 1XU,L24,1XU,66,34,32,30
L24 1XW,L24,1XW,23,10,13,8
L24 1YR,L24,1YR,122,57,65,46
L24 1YS,L24,1YS,35,13,22,13
L24 1YT,L24,1YT,55,22,33,17
L24 2RA,L24,2RA,165,72,93,74
L24 2RB,L24,2RB,45,13,32,39
L24 2SA,L24,2SA,62,26,36,32
L24 2SJ,L24,2SJ,17,8,9,11
L24 2SN,L24,2SN,22,11,11,14
L24 2SP,L24,2SP,62,28,34,28
L24 2SR,L24,2SR,27,15,12,25
L24 2SS,L24,2SS,105,54,51,40
L24 2ST,L24,2ST,91,45,46,31
L24 2SU,L24,2SU,113,47,66,41
L24 2SW,L24,2SW,89,38,51,33
L24 2SX,L24,2SX,59,30,29,26
L24 2SY,L24,2SY,60,22,38,26
L24 2SZ,L24,2SZ,44,20,24,21
L24 2TA,L24,2TA,73,36,37,28
L24 2TB,L24,2TB,75,28,47,17
L24 2TD,L24,2TD,44,19,25,20
L24 2TE,L24,2TE,69,30,39,26
L24 2TF,L24,2TF,51,25,26,20
L24 2TG,L24,2TG,36,20,16,16
L24 2TH,L24,2TH,27,15,12,14
L24 2TJ,L24,2TJ,83,36,47,39
L24 2TL,L24,2TL,116,52,64,53
L24 2TN,L24,2TN,111,52,59,44
L24 2TP,L24,2TP,92,48,44,46
L24 2TQ,L24,2TQ,24,14,10,13
L24 2TR,L24,2TR,70,36,34,31
L24 2TS,L24,2TS,69,33,36,26
L24 2TT,L24,2TT,63,27,36,21
L24 2TW,L24,2TW,95,45,50,38
L24 2TX,L24,2TX,58,27,31,29
L24 2TY,L24,2TY,64,27,37,33
L24 2TZ,L24,2TZ,56,22,34,29
L24 2UA,L24,2UA,63,24,39,19
L24 2UB,L24,2UB,84,33,51,32
L24 2UD,L24,2UD,54,22,32,19
L24 2UE,L24,2UE,34,18,16,14
L24 2UF,L24,2UF,66,31,35,29
L24 2UG,L24,2UG,99,46,53,35
L24 2UH,L24,2UH,14,5,9,8
L24 2UJ,L24,2UJ,97,41,56,35
L24 2UL,L24,2UL,84,41,43,30
L24 2UN,L24,2UN,30,14,16,13
L24 2UP,L24,2UP,79,31,48,34
L24 2UQ,L24,2UQ,70,35,35,31
L24 2UR,L24,2UR,109,55,54,42
L24 2US,L24,2US,32,16,16,12
L24 2UT,L24,2UT,51,20,31,16
L24 2UU,L24,2UU,15,5,10,8
L24 2UW,L24,2UW,21,11,10,10
L24 2UX,L24,2UX,31,15,16,16
L24 2UY,L24,2UY,38,19,19,17
L24 2UZ,L24,2UZ,35,13,22,15
L24 2XG,L24,2XG,70,38,32,30
L24 2XH,L24,2XH,22,14,8,21
L24 2XJ,L24,2XJ,12,3,9,8
L24 2XL,L24,2XL,19,8,11,10
L24 2XN,L24,2XN,15,8,7,10
L24 3TA,L24,3TA,87,38,49,33
L24 3TD,L24,3TD,42,20,22,16
L24 3TE,L24,3TE,18,7,11,8
L24 3TF,L24,3TF,65,31,34,26
L24 3TG,L24,3TG,83,42,41,32
L24 3TH,L24,3TH,95,49,46,37
L24 3TJ,L24,3TJ,82,34,48,31
L24 3TL,L24,3TL,46,24,22,20
L24 3TN,L24,3TN,87,37,50,34
L24 3TP,L24,3TP,110,50,60,45
L24 3TQ,L24,3TQ,104,50,54,37
L24 3TR,L24,3TR,98,51,47,46
L24 3TS,L24,3TS,41,21,20,15
L24 3TT,L24,3TT,106,47,59,36
L24 3TU,L24,3TU,60,27,33,28
L24 3TW,L24,3TW,77,41,36,35
L24 3TX,L24,3TX,36,17,19,13
L24 3TY,L24,3TY,51,23,28,25
L24 3TZ,L24,3TZ,93,48,45,39
L24 3UA,L24,3UA,87,41,46,44
L24 3UB,L24,3UB,123,65,58,48
L24 3UD,L24,3UD,72,29,43,25
L24 3UE,L24,3UE,88,42,46,37
L24 3UF,L24,3UF,123,56,67,51
L24 3UG,L24,3UG,48,30,18,17
L24 3UH,L24,3UH,62,22,40,26
L24 3UJ,L24,3UJ,31,11,20,13
L24 3UL,L24,3UL,41,24,17,20
L24 3UN,L24,3UN,86,41,45,41
L24 3UP,L24,3UP,68,35,33,27
L24 3UQ,L24,3UQ,47,21,26,19
L24 3UR,L24,3UR,77,35,42,38
L24 3US,L24,3US,53,28,25,31
L24 3UT,L24,3UT,84,49,35,30
L24 3UU,L24,3UU,11,7,4,6
L24 3UW,L24,3UW,66,31,35,27
L24 3UX,L24,3UX,62,34,28,30
L24 3UY,L24,3UY,20,11,9,12
L24 3UZ,L24,3UZ,55,25,30,21
L24 3XA,L24,3XA,80,30,50,40
L24 3XB,L24,3XB,35,15,20,19
L24 3XD,L24,3XD,98,44,54,40
L24 3XE,L24,3XE,103,42,61,45
L24 3XF,L24,3XF,90,39,51,38
L24 3XG,L24,3XG,36,20,16,19
L24 3XQ,L24,3XQ,45,18,27,18
L24 4AD,L24,4AD,38,18,20,13
L24 4AE,L24,4AE,18,8,10,10
L24 4AF,L24,4AF,47,30,17,19
L24 4AG,L24,4AG,32,16,16,20
L24 4AH,L24,4AH,8,4,4,4
L24 4AJ,L24,4AJ,8,2,6,3
L24 4AL,L24,4AL,12,6,6,7
L24 4AN,L24,4AN,33,14,19,19
L24 4AP,L24,4AP,8,1,7,3
L24 4AQ,L24,4AQ,42,19,23,17
L24 4AR,L24,4AR,20,8,12,9
L24 4AS,L24,4AS,10,5,5,4
L24 4AT,L24,4AT,31,15,16,13
L24 4AU,L24,4AU,28,12,16,12
L24 4AW,L24,4AW,4,2,2,3
L24 4AX,L24,4AX,54,31,23,25
L24 4AY,L24,4AY,52,22,30,21
L24 4AZ,L24,4AZ,4,2,2,1
L24 4BA,L24,4BA,80,41,39,30
L24 4BB,L24,4BB,34,21,13,20
L24 4BD,L24,4BD,96,48,48,38
L24 4BE,L24,4BE,43,25,18,17
L24 4BG,L24,4BG,20,11,9,8
L24 4BH,L24,4BH,47,19,28,18
L24 4BJ,L24,4BJ,17,8,9,6
L24 4BL,L24,4BL,10,5,5,5
L24 4BN,L24,4BN,14,7,7,5
L24 4BP,L24,4BP,18,8,10,8
L24 4BQ,L24,4BQ,12,6,6,5
L24 4BR,L24,4BR,12,7,5,5
L24 4BS,L24,4BS,11,7,4,4
L24 4BT,L24,4BT,8,4,4,5
L24 4BU,L24,4BU,10,3,7,5
L24 4BW,L24,4BW,32,13,19,15
L24 4BX,L24,4BX,27,13,14,11
L24 4BY,L24,4BY,57,34,23,22
L24 4BZ,L24,4BZ,3,2,1,2
L24 4EA,L24,4EA,8,3,5,3
L24 4EB,L24,4EB,44,20,24,17
L24 5RB,L24,5RB,49,22,27,21
L24 5RD,L24,5RD,26,10,16,13
L24 5RE,L24,5RE,20,8,12,9
L24 5RF,L24,5RF,19,9,10,10
L24 5RG,L24,5RG,45,22,23,19
L24 5RJ,L24,5RJ,11,5,6,4
L24 5RL,L24,5RL,9,6,3,3
L24 5RN,L24,5RN,58,29,29,23
L24 5RP,L24,5RP,15,8,7,6
L24 5RQ,L24,5RQ,7,3,4,3
L24 5RR,L24,5RR,80,37,43,29
L24 5RS,L24,5RS,25,16,9,9
L24 5RT,L24,5RT,23,10,13,13
L24 5RU,L24,5RU,91,47,44,38
L24 5RW,L24,5RW,68,32,36,29
L24 5RX,L24,5RX,31,19,12,14
L24 5RY,L24,5RY,36,18,18,16
L24 5RZ,L24,5RZ,31,17,14,10
L24 5SA,L24,5SA,33,16,17,17
L24 5SB,L24,5SB,23,9,14,9
L24 5SD,L24,5SD,29,12,17,14
L24 5SE,L24,5SE,25,12,13,9
L24 5SF,L24,5SF,39,21,18,17
L24 5SG,L24,5SG,7,3,4,4
L24 6SA,L24,6SA,30,15,15,18
L24 6SB,L24,6SB,59,29,30,31
L24 6SD,L24,6SD,41,21,20,21
L24 6SE,L24,6SE,87,35,52,36
L24 6SF,L24,6SF,86,42,44,44
L24 6SG,L24,6SG,63,32,31,27
L24 6SH,L24,6SH,30,14,16,15
L24 6SJ,L24,6SJ,10,3,7,9
L24 6SL,L24,6SL,30,18,12,15
L24 6SN,L24,6SN,73,33,40,35
L24 6SP,L24,6SP,39,16,23,18
L24 6SQ,L24,6SQ,78,35,43,33
L24 6SR,L24,6SR,27,9,18,12
L24 6SS,L24,6SS,74,32,42,29
L24 6ST,L24,6ST,32,13,19,13
L24 6SU,L24,6SU,92,41,51,37
L24 6SW,L24,6SW,46,23,23,18
L24 6SX,L24,6SX,54,29,25,25
L24 6SY,L24,6SY,51,33,18,21
L24 6SZ,L24,6SZ,91,37,54,35
L24 6TA,L24,6TA,31,16,15,13
L24 6TB,L24,6TB,30,11,19,14
L24 6TD,L24,6TD,14,8,6,7
L24 6TE,L24,6TE,44,18,26,36
L24 6TQ,L24,6TQ,36,17,19,21
L24 7RA,L24,7RA,42,22,20,16
L24 7RB,L24,7RB,57,28,29,31
L24 7RD,L24,7RD,40,19,21,20
L24 7RE,L24,7RE,53,21,32,19
L24 7RF,L24,7RF,77,51,26,38
L24 7RG,L24,7RG,73,33,40,28
L24 7RH,L24,7RH,110,45,65,45
L24 7RJ,L24,7RJ,55,26,29,23
L24 7RL,L24,7RL,96,44,52,43
L24 7RN,L24,7RN,56,25,31,25
L24 7RP,L24,7RP,21,11,10,13
L24 7RQ,L24,7RQ,67,34,33,28
L24 7RR,L24,7RR,53,30,23,32
L24 7RS,L24,7RS,84,42,42,31
L24 7RT,L24,7RT,31,14,17,13
L24 7RU,L24,7RU,36,16,20,15
L24 7RW,L24,7RW,69,32,37,26
L24 7RX,L24,7RX,34,18,16,14
L24 7RY,L24,7RY,59,25,34,26
L24 7RZ,L24,7RZ,36,17,19,15
L24 7SA,L24,7SA,33,19,14,17
L24 7SB,L24,7SB,27,15,12,15
L24 7SD,L24,7SD,67,36,31,25
L24 7SE,L24,7SE,25,11,14,14
L24 7SF,L24,7SF,50,22,28,19
L24 7SG,L24,7SG,37,19,18,14
L24 7SH,L24,7SH,36,25,11,35
L24 7SQ,L24,7SQ,37,17,20,13
L24 8QA,L24,8QA,32,19,13,15
L24 9BA,L24,9BA,1,1,0,1
L24 9BF,L24,9BF,3,0,3,1
L24 9BG,L24,9BG,2,2,0,2
L24 9GB,L24,9GB,7,2,5,4
L24 9GQ,L24,9GQ,13,6,7,6
L24 9HJ,L24,9HJ,2,1,1,1
L24 9LD,L24,9LD,61,30,31,25
L24 9LG,L24,9LG,115,56,59,49
L24 9LH,L24,9LH,88,50,38,41
L24 9LJ,L24,9LJ,105,53,52,60
L24 9LL,L24,9LL,165,82,83,82
L24 9LP,L24,9LP,61,29,32,29
L24 9LR,L24,9LR,60,29,31,33
L24 9LW,L24,9LW,202,88,114,84
L25 0LA,L25,0LA,65,38,27,20
L25 0LB,L25,0LB,23,10,13,6
L25 0LD,L25,0LD,47,25,22,22
L25 0LE,L25,0LE,12,7,5,5
L25 0LF,L25,0LF,38,18,20,21
L25 0LG,L25,0LG,9,5,4,3
L25 0LH,L25,0LH,34,16,18,16
L25 0LJ,L25,0LJ,84,46,38,29
L25 0LL,L25,0LL,82,43,39,30
L25 0LN,L25,0LN,53,27,26,23
L25 0LP,L25,0LP,39,24,15,16
L25 0LQ,L25,0LQ,23,15,8,12
L25 0LR,L25,0LR,4,2,2,2
L25 0LS,L25,0LS,74,36,38,32
L25 0LT,L25,0LT,93,46,47,37
L25 0LU,L25,0LU,77,43,34,34
L25 0LW,L25,0LW,59,29,30,25
L25 0LX,L25,0LX,74,37,37,32
L25 0LY,L25,0LY,41,22,19,17
L25 0LZ,L25,0LZ,35,16,19,14
L25 0NA,L25,0NA,74,35,39,30
L25 0NB,L25,0NB,51,25,26,17
L25 0ND,L25,0ND,87,45,42,35
L25 0NG,L25,0NG,71,34,37,30
L25 0NH,L25,0NH,47,22,25,20
L25 0NJ,L25,0NJ,43,26,17,17
L25 0NL,L25,0NL,15,6,9,7
L25 0NN,L25,0NN,2,1,1,2
L25 0NP,L25,0NP,71,35,36,24
L25 0NQ,L25,0NQ,75,36,39,26
L25 0NR,L25,0NR,97,51,46,38
L25 0NS,L25,0NS,42,19,23,16
L25 0NT,L25,0NT,95,44,51,33
L25 0NU,L25,0NU,98,53,45,35
L25 0NX,L25,0NX,107,41,66,43
L25 0NY,L25,0NY,48,22,26,23
L25 0PA,L25,0PA,41,21,20,19
L25 0PB,L25,0PB,20,8,12,9
L25 0PD,L25,0PD,23,11,12,9
L25 0PE,L25,0PE,51,24,27,21
L25 0PF,L25,0PF,56,32,24,25
L25 0PG,L25,0PG,63,28,35,23
L25 0PH,L25,0PH,73,31,42,33
L25 0PJ,L25,0PJ,99,51,48,39
L25 0PL,L25,0PL,28,14,14,10
L25 0PN,L25,0PN,59,25,34,27
L25 0PP,L25,0PP,73,32,41,31
L25 0PQ,L25,0PQ,86,33,53,30
L25 0PR,L25,0PR,87,41,46,34
L25 0PS,L25,0PS,59,26,33,25
L25 0PT,L25,0PT,19,9,10,8
L25 0PU,L25,0PU,45,23,22,21
L25 0PW,L25,0PW,72,36,36,31
L25 0PX,L25,0PX,47,24,23,19
L25 0PY,L25,0PY,117,56,61,48
L25 0PZ,L25,0PZ,138,73,65,54
L25 0QA,L25,0QA,7,3,4,4
L25 0QB,L25,0QB,43,24,19,16
L25 0QD,L25,0QD,40,15,25,16
L25 0QE,L25,0QE,39,19,20,17
L25 0QF,L25,0QF,48,27,21,15
L25 0QG,L25,0QG,73,37,36,24
L25 0QH,L25,0QH,10,7,3,4
L25 0QJ,L25,0QJ,49,23,26,42
L25 0QQ,L25,0QQ,70,35,35,26
L25 0QR,L25,0QR,103,48,55,43
L25 0QS,L25,0QS,94,49,45,43
L25 1AB,L25,1AB,11,7,4,4
L25 1AD,L25,1AD,12,7,5,6
L25 1BA,L25,1BA,14,10,4,7
L25 1GA,L25,1GA,11,7,4,7
L25 1JA,L25,1JA,16,6,10,13
L25 1JB,L25,1JB,36,13,23,13
L25 1NA,L25,1NA,30,14,16,17
L25 1NB,L25,1NB,47,20,27,27
L25 1ND,L25,1ND,35,16,19,22
L25 1NE,L25,1NE,74,43,31,34
L25 1NF,L25,1NF,12,6,6,4
L25 1NG,L25,1NG,30,14,16,16
L25 1NH,L25,1NH,62,31,31,34
L25 1NJ,L25,1NJ,67,31,36,28
L25 1NL,L25,1NL,18,10,8,7
L25 1NN,L25,1NN,47,23,24,21
L25 1NP,L25,1NP,32,14,18,12
L25 1NQ,L25,1NQ,41,22,19,21
L25 1NS,L25,1NS,27,12,15,11
L25 1NU,L25,1NU,12,3,9,6
L25 1NW,L25,1NW,35,17,18,16
L25 1NX,L25,1NX,43,17,26,23
L25 1NY,L25,1NY,42,20,22,20
L25 1NZ,L25,1NZ,50,22,28,26
L25 1PA,L25,1PA,67,36,31,31
L25 1PB,L25,1PB,18,8,10,7
L25 1PF,L25,1PF,65,34,31,25
L25 1PG,L25,1PG,11,4,7,6
L25 1PH,L25,1PH,23,9,14,14
L25 1PJ,L25,1PJ,63,32,31,31
L25 1PL,L25,1PL,42,21,21,17
L25 1PN,L25,1PN,48,23,25,22
L25 1PP,L25,1PP,73,41,32,27
L25 1PQ,L25,1PQ,10,3,7,8
L25 1PR,L25,1PR,37,18,19,18
L25 1PS,L25,1PS,54,27,27,24
L25 1PT,L25,1PT,27,15,12,20
L25 1PU,L25,1PU,43,20,23,29
L25 1PW,L25,1PW,1,0,1,1
L25 1PX,L25,1PX,34,16,18,16
L25 1PY,L25,1PY,31,19,12,20
L25 1PZ,L25,1PZ,42,25,17,21
L25 1QA,L25,1QA,33,15,18,18
L25 1QD,L25,1QD,43,24,19,17
L25 1QE,L25,1QE,17,9,8,7
L25 1QP,L25,1QP,41,25,16,22
L25 1QR,L25,1QR,30,17,13,13
L25 1QW,L25,1QW,73,45,28,49
L25 1RA,L25,1RA,29,12,17,16
L25 1RB,L25,1RB,23,9,14,11
L25 1RD,L25,1RD,33,15,18,26
L25 1RE,L25,1RE,46,24,22,24
L25 1RF,L25,1RF,9,4,5,5
L25 1RG,L25,1RG,23,11,12,14
L25 1RQ,L25,1RQ,10,7,3,10
L25 1RR,L25,1RR,44,20,24,33
L25 1RS,L25,1RS,12,4,8,9
L25 1RT,L25,1RT,42,11,31,39
L25 1RW,L25,1RW,15,8,7,9
L25 2BA,L25,2BA,51,24,27,35
L25 2NH,L25,2NH,55,29,26,26
L25 2NJ,L25,2NJ,22,9,13,10
L25 2NL,L25,2NL,64,30,34,25
L25 2NN,L25,2NN,32,17,15,19
L25 2NP,L25,2NP,71,31,40,33
L25 2NQ,L25,2NQ,25,13,12,9
L25 2NS,L25,2NS,43,19,24,18
L25 2NT,L25,2NT,75,32,43,25
L25 2NU,L25,2NU,42,20,22,23
L25 2NW,L25,2NW,94,39,55,39
L25 2NX,L25,2NX,58,25,33,30
L25 2NY,L25,2NY,78,31,47,38
L25 2PA,L25,2PA,28,12,16,10
L25 2PE,L25,2PE,10,5,5,7
L25 2PH,L25,2PH,25,11,14,12
L25 2PJ,L25,2PJ,31,15,16,12
L25 2PN,L25,2PN,8,3,5,4
L25 2PQ,L25,2PQ,26,15,11,8
L25 2PT,L25,2PT,19,10,9,7
L25 2PU,L25,2PU,50,22,28,22
L25 2PX,L25,2PX,40,21,19,17
L25 2PY,L25,2PY,25,9,16,10
L25 2QB,L25,2QB,25,14,11,13
L25 2QD,L25,2QD,103,47,56,39
L25 2QH,L25,2QH,45,25,20,22
L25 2QJ,L25,2QJ,28,16,12,12
L25 2QL,L25,2QL,28,17,11,12
L25 2QN,L25,2QN,96,40,56,43
L25 2QP,L25,2QP,7,3,4,3
L25 2QR,L25,2QR,87,44,43,36
L25 2QS,L25,2QS,26,14,12,11
L25 2QT,L25,2QT,35,16,19,17
L25 2QW,L25,2QW,58,28,30,20
L25 2RA,L25,2RA,44,17,27,14
L25 2RB,L25,2RB,119,61,58,48
L25 2RD,L25,2RD,10,4,6,6
L25 2RL,L25,2RL,2,1,1,1
L25 2RP,L25,2RP,29,11,18,12
L25 2RQ,L25,2RQ,1,1,0,1
L25 2RR,L25,2RR,49,27,22,21
L25 2RS,L25,2RS,32,13,19,13
L25 2RT,L25,2RT,69,31,38,30
L25 2RU,L25,2RU,27,12,15,13
L25 2RW,L25,2RW,2,2,0,2
L25 2RX,L25,2RX,33,16,17,11
L25 2RY,L25,2RY,33,17,16,18
L25 2RZ,L25,2RZ,26,15,11,10
L25 2SA,L25,2SA,59,30,29,21
L25 2SB,L25,2SB,75,34,41,29
L25 2SD,L25,2SD,20,7,13,8
L25 2SE,L25,2SE,37,15,22,24
L25 2SF,L25,2SF,39,21,18,18
L25 2SG,L25,2SG,21,11,10,8
L25 2SH,L25,2SH,21,9,12,8
L25 2SJ,L25,2SJ,31,14,17,9
L25 2SL,L25,2SL,37,15,22,18
L25 2SN,L25,2SN,39,18,21,19
L25 2SP,L25,2SP,25,11,14,15
L25 2SQ,L25,2SQ,48,19,29,18
L25 2SR,L25,2SR,35,19,16,26
L25 2SS,L25,2SS,9,4,5,4
L25 2ST,L25,2ST,32,16,16,11
L25 2SU,L25,2SU,30,8,22,13
L25 2SW,L25,2SW,27,11,16,10
L25 2SZ,L25,2SZ,27,11,16,12
L25 2TG,L25,2TG,8,6,2,5
L25 2TQ,L25,2TQ,5,3,2,4
L25 2UD,L25,2UD,15,6,9,12
L25 2XP,L25,2XP,19,7,12,7
L25 2XS,L25,2XS,126,58,68,63
L25 2XT,L25,2XT,15,9,6,3
L25 2XU,L25,2XU,132,64,68,55
L25 2XW,L25,2XW,53,23,30,29
L25 2XX,L25,2XX,170,78,92,67
L25 2XZ,L25,2XZ,22,7,15,19
L25 2YD,L25,2YD,56,22,34,22
L25 2YE,L25,2YE,33,19,14,16
L25 2YF,L25,2YF,94,45,49,38
L25 2YG,L25,2YG,59,28,31,17
L25 2YH,L25,2YH,52,21,31,26
L25 2YJ,L25,2YJ,25,10,15,9
L25 2YL,L25,2YL,17,9,8,9
L25 2YP,L25,2YP,43,18,25,16
L25 2YQ,L25,2YQ,19,8,11,8
L25 2YR,L25,2YR,34,14,20,10
L25 2YS,L25,2YS,35,15,20,17
L25 2YT,L25,2YT,38,17,21,16
L25 2YU,L25,2YU,37,14,23,19
L25 2YW,L25,2YW,68,26,42,32
L25 3NF,L25,3NF,3,1,2,2
L25 3NR,L25,3NR,49,26,23,28
L25 3NS,L25,3NS,32,16,16,12
L25 3NT,L25,3NT,46,22,24,18
L25 3NU,L25,3NU,11,7,4,7
L25 3NW,L25,3NW,27,13,14,17
L25 3NX,L25,3NX,34,15,19,13
L25 3NY,L25,3NY,35,17,18,14
L25 3NZ,L25,3NZ,39,16,23,15
L25 3PA,L25,3PA,11,3,8,4
L25 3PB,L25,3PB,52,26,26,26
L25 3PD,L25,3PD,7,2,5,4
L25 3PE,L25,3PE,56,28,28,28
L25 3PG,L25,3PG,39,19,20,20
L25 3PH,L25,3PH,47,22,25,22
L25 3PJ,L25,3PJ,74,39,35,26
L25 3PL,L25,3PL,31,16,15,10
L25 3PN,L25,3PN,16,6,10,10
L25 3PP,L25,3PP,40,21,19,20
L25 3PQ,L25,3PQ,26,12,14,12
L25 3PR,L25,3PR,37,18,19,16
L25 3PS,L25,3PS,35,15,20,19
L25 3PT,L25,3PT,54,24,30,22
L25 3PU,L25,3PU,37,15,22,19
L25 3PW,L25,3PW,34,18,16,16
L25 3PX,L25,3PX,28,14,14,14
L25 3PY,L25,3PY,108,58,50,43
L25 3PZ,L25,3PZ,52,25,27,26
L25 3QA,L25,3QA,36,16,20,16
L25 3QB,L25,3QB,50,28,22,19
L25 3QD,L25,3QD,60,28,32,28
L25 3QE,L25,3QE,82,40,42,35
L25 3QF,L25,3QF,11,3,8,7
L25 3QG,L25,3QG,38,18,20,16
L25 3QH,L25,3QH,42,16,26,26
L25 3QJ,L25,3QJ,31,13,18,10
L25 3QL,L25,3QL,52,26,26,22
L25 3QN,L25,3QN,53,31,22,22
L25 3QP,L25,3QP,77,31,46,26
L25 3QQ,L25,3QQ,21,10,11,11
L25 3QR,L25,3QR,80,40,40,32
L25 3QS,L25,3QS,97,46,51,46
L25 3QT,L25,3QT,54,28,26,25
L25 3QU,L25,3QU,75,40,35,31
L25 3QW,L25,3QW,53,28,25,24
L25 3QX,L25,3QX,96,53,43,32
L25 3RA,L25,3RA,72,31,41,35
L25 3RL,L25,3RL,72,43,29,45
L25 3RN,L25,3RN,68,42,26,35
L25 3RP,L25,3RP,40,20,20,22
L25 3RR,L25,3RR,28,10,18,13
L25 3RS,L25,3RS,49,27,22,24
L25 3RT,L25,3RT,33,16,17,21
L25 3RU,L25,3RU,11,8,3,4
L25 3RW,L25,3RW,95,54,41,44
L25 3RX,L25,3RX,63,34,29,25
L25 3RY,L25,3RY,25,13,12,14
L25 3RZ,L25,3RZ,13,7,6,9
L25 3SA,L25,3SA,14,7,7,7
L25 3SB,L25,3SB,34,19,15,16
L25 3SD,L25,3SD,63,30,33,27
L25 3SE,L25,3SE,80,34,46,34
L25 3SF,L25,3SF,85,39,46,32
L25 3SG,L25,3SG,24,10,14,16
L25 3SH,L25,3SH,117,57,60,44
L25 3SJ,L25,3SJ,16,7,9,7
L25 3SL,L25,3SL,5,3,2,5
L25 3SN,L25,3SN,23,8,15,10
L25 3SQ,L25,3SQ,6,3,3,3
L25 3SR,L25,3SR,42,20,22,38
L25 3SS,L25,3SS,47,30,17,16
L25 3SZ,L25,3SZ,73,34,39,23
L25 3TA,L25,3TA,5,3,2,2
L25 4AG,L25,4AG,57,27,30,27
L25 4RA,L25,4RA,14,7,7,9
L25 4RD,L25,4RD,8,5,3,4
L25 4RE,L25,4RE,26,12,14,13
L25 4RF,L25,4RF,9,5,4,5
L25 4RG,L25,4RG,39,17,22,18
L25 4RH,L25,4RH,35,18,17,11
L25 4RJ,L25,4RJ,14,6,8,7
L25 4RL,L25,4RL,17,9,8,9
L25 4RN,L25,4RN,35,17,18,15
L25 4RP,L25,4RP,46,25,21,17
L25 4RQ,L25,4RQ,22,11,11,13
L25 4RR,L25,4RR,66,34,32,23
L25 4RS,L25,4RS,37,17,20,24
L25 4RT,L25,4RT,26,15,11,10
L25 4RU,L25,4RU,36,18,18,16
L25 4RW,L25,4RW,20,10,10,8
L25 4RX,L25,4RX,36,15,21,17
L25 4RY,L25,4RY,25,12,13,12
L25 4RZ,L25,4RZ,22,7,15,7
L25 4SA,L25,4SA,57,24,33,28
L25 4SB,L25,4SB,2,1,1,1
L25 4SE,L25,4SE,5,2,3,4
L25 4SF,L25,4SF,40,15,25,20
L25 4SG,L25,4SG,82,39,43,37
L25 4SH,L25,4SH,22,12,10,9
L25 4SJ,L25,4SJ,12,5,7,5
L25 4SL,L25,4SL,16,8,8,8
L25 4SN,L25,4SN,67,36,31,24
L25 4SP,L25,4SP,34,16,18,16
L25 4SQ,L25,4SQ,33,18,15,14
L25 4SR,L25,4SR,28,14,14,14
L25 4SS,L25,4SS,30,13,17,13
L25 4ST,L25,4ST,86,42,44,45
L25 4SU,L25,4SU,91,41,50,40
L25 4SW,L25,4SW,112,56,56,42
L25 4SX,L25,4SX,33,16,17,13
L25 4SY,L25,4SY,57,29,28,22
L25 4SZ,L25,4SZ,66,28,38,22
L25 4TA,L25,4TA,26,13,13,17
L25 4TB,L25,4TB,22,11,11,9
L25 4TD,L25,4TD,17,8,9,4
L25 4TE,L25,4TE,13,8,5,12
L25 4TF,L25,4TF,19,4,15,15
L25 4TG,L25,4TG,12,7,5,4
L25 4TH,L25,4TH,15,6,9,9
L25 4TJ,L25,4TJ,26,14,12,13
L25 4TL,L25,4TL,44,19,25,25
L25 4TN,L25,4TN,22,11,11,11
L25 4TP,L25,4TP,44,20,24,24
L25 4TQ,L25,4TQ,52,24,28,19
L25 4TR,L25,4TR,36,20,16,18
L25 4TS,L25,4TS,23,14,9,11
L25 4TT,L25,4TT,38,21,17,16
L25 4TU,L25,4TU,12,5,7,5
L25 4TW,L25,4TW,37,16,21,17
L25 4TX,L25,4TX,25,11,14,14
L25 4TY,L25,4TY,24,11,13,13
L25 4TZ,L25,4TZ,14,6,8,5
L25 4UA,L25,4UA,18,9,9,8
L25 4UB,L25,4UB,37,18,19,17
L25 4UD,L25,4UD,14,8,6,7
L25 4UE,L25,4UE,42,25,17,23
L25 4UF,L25,4UF,62,38,24,53
L25 4UG,L25,4UG,58,29,29,26
L25 4UH,L25,4UH,34,15,19,14
L25 4UN,L25,4UN,10,6,4,4
L25 4UQ,L25,4UQ,55,23,32,26
L25 5BA,L25,5BA,15,7,8,6
L25 5HA,L25,5HA,132,72,60,82
L25 5HJ,L25,5HJ,68,27,41,23
L25 5HL,L25,5HL,12,6,6,5
L25 5HN,L25,5HN,104,54,50,52
L25 5HP,L25,5HP,92,49,43,32
L25 5HR,L25,5HR,33,17,16,15
L25 5HS,L25,5HS,47,24,23,16
L25 5HT,L25,5HT,37,18,19,12
L25 5HU,L25,5HU,24,13,11,22
L25 5HX,L25,5HX,46,25,21,19
L25 5JA,L25,5JA,19,8,11,10
L25 5JE,L25,5JE,32,16,16,20
L25 5JF,L25,5JF,43,26,17,26
L25 5JG,L25,5JG,7,4,3,3
L25 5JH,L25,5JH,11,5,6,7
L25 5JL,L25,5JL,17,7,10,9
L25 5JN,L25,5JN,20,10,10,7
L25 5JP,L25,5JP,14,7,7,6
L25 5JQ,L25,5JQ,13,7,6,4
L25 5JR,L25,5JR,4,2,2,2
L25 5JS,L25,5JS,19,11,8,10
L25 5JT,L25,5JT,19,9,10,8
L25 5JU,L25,5JU,22,11,11,9
L25 5JX,L25,5JX,9,4,5,2
L25 5JY,L25,5JY,3,2,1,3
L25 5JZ,L25,5JZ,43,20,23,19
L25 5LA,L25,5LA,73,34,39,24
L25 5LB,L25,5LB,79,37,42,31
L25 5LD,L25,5LD,21,9,12,13
L25 5LE,L25,5LE,8,5,3,4
L25 5LF,L25,5LF,1,0,1,1
L25 5LG,L25,5LG,43,21,22,17
L25 5LH,L25,5LH,39,23,16,19
L25 5LJ,L25,5LJ,18,10,8,8
L25 5LL,L25,5LL,35,14,21,17
L25 5LN,L25,5LN,101,44,57,43
L25 5LP,L25,5LP,142,57,85,56
L25 5LQ,L25,5LQ,36,16,20,19
L25 5LR,L25,5LR,111,55,56,57
L25 5LS,L25,5LS,58,27,31,39
L25 5LT,L25,5LT,71,41,30,41
L25 5LU,L25,5LU,24,14,10,10
L25 5LW,L25,5LW,24,10,14,13
L25 5LX,L25,5LX,82,41,41,45
L25 5LY,L25,5LY,48,25,23,35
L25 5LZ,L25,5LZ,59,32,27,34
L25 5NA,L25,5NA,52,19,33,25
L25 5NB,L25,5NB,6,5,1,6
L25 5ND,L25,5ND,32,14,18,15
L25 5NE,L25,5NE,46,23,23,25
L25 5NF,L25,5NF,99,42,57,49
L25 5NG,L25,5NG,36,16,20,25
L25 5NH,L25,5NH,15,8,7,9
L25 5NJ,L25,5NJ,52,28,24,24
L25 5NL,L25,5NL,43,20,23,15
L25 5NN,L25,5NN,8,6,2,2
L25 5NP,L25,5NP,38,16,22,15
L25 5NQ,L25,5NQ,26,15,11,13
L25 5NR,L25,5NR,77,38,39,35
L25 5NS,L25,5NS,59,29,30,24
L25 5NT,L25,5NT,70,37,33,26
L25 5NU,L25,5NU,54,25,29,28
L25 5NW,L25,5NW,3,1,2,1
L25 5NX,L25,5NX,94,47,47,38
L25 5NY,L25,5NY,52,28,24,21
L25 5NZ,L25,5NZ,41,18,23,16
L25 5PA,L25,5PA,68,31,37,27
L25 5PB,L25,5PB,59,31,28,22
L25 5PD,L25,5PD,52,26,26,24
L25 5PE,L25,5PE,17,8,9,9
L25 5PF,L25,5PF,31,16,15,15
L25 5PG,L25,5PG,100,39,61,56
L25 5PH,L25,5PH,33,16,17,22
L25 5PJ,L25,5PJ,50,17,33,20
L25 5PL,L25,5PL,78,35,43,34
L25 5PN,L25,5PN,77,38,39,38
L25 5PP,L25,5PP,61,27,34,27
L25 5PQ,L25,5PQ,27,14,13,10
L25 5PR,L25,5PR,27,15,12,18
L25 5PS,L25,5PS,31,15,16,22
L25 5PT,L25,5PT,24,14,10,17
L25 5PU,L25,5PU,40,15,25,18
L25 5PW,L25,5PW,70,32,38,30
L25 5PX,L25,5PX,98,42,56,44
L25 5PY,L25,5PY,40,22,18,35
L25 5PZ,L25,5PZ,44,23,21,19
L25 5QB,L25,5QB,10,4,6,6
L25 5QE,L25,5QE,19,11,8,7
L25 5QH,L25,5QH,21,7,14,10
L25 5QQ,L25,5QQ,35,14,21,20
L25 6DA,L25,6DA,25,14,11,11
L25 6DB,L25,6DB,54,28,26,19
L25 6DD,L25,6DD,21,11,10,12
L25 6DF,L25,6DF,18,8,10,12
L25 6DG,L25,6DG,46,21,25,18
L25 6DH,L25,6DH,87,34,53,34
L25 6DJ,L25,6DJ,43,19,24,14
L25 6DL,L25,6DL,46,17,29,18
L25 6DN,L25,6DN,39,16,23,17
L25 6DP,L25,6DP,49,28,21,19
L25 6DQ,L25,6DQ,66,31,35,28
L25 6DR,L25,6DR,28,14,14,11
L25 6DS,L25,6DS,8,3,5,2
L25 6DT,L25,6DT,4,2,2,2
L25 6DU,L25,6DU,18,10,8,7
L25 6DW,L25,6DW,33,14,19,13
L25 6DX,L25,6DX,12,7,5,4
L25 6DY,L25,6DY,18,7,11,8
L25 6DZ,L25,6DZ,14,7,7,5
L25 6EA,L25,6EA,11,6,5,5
L25 6EB,L25,6EB,22,16,6,9
L25 6ED,L25,6ED,46,22,24,20
L25 6EE,L25,6EE,10,5,5,3
L25 6EG,L25,6EG,2,2,0,0
L25 6EH,L25,6EH,47,25,22,19
L25 6EJ,L25,6EJ,25,11,14,6
L25 6EL,L25,6EL,21,14,7,7
L25 6EN,L25,6EN,5,2,3,2
L25 6EP,L25,6EP,22,11,11,8
L25 6EQ,L25,6EQ,16,11,5,6
L25 6ER,L25,6ER,31,15,16,9
L25 6ES,L25,6ES,30,17,13,10
L25 6ET,L25,6ET,15,6,9,9
L25 6EU,L25,6EU,35,21,14,12
L25 6EW,L25,6EW,5,2,3,3
L25 6EX,L25,6EX,72,39,33,32
L25 6EY,L25,6EY,13,4,9,9
L25 6EZ,L25,6EZ,61,20,41,46
L25 6HA,L25,6HA,33,16,17,17
L25 6HB,L25,6HB,20,10,10,10
L25 6HD,L25,6HD,64,30,34,37
L25 6HE,L25,6HE,48,24,24,19
L25 6HF,L25,6HF,26,16,10,15
L25 6HG,L25,6HG,20,9,11,10
L25 6HH,L25,6HH,21,11,10,8
L25 6HJ,L25,6HJ,23,12,11,12
L25 6HL,L25,6HL,13,9,4,8
L25 6HN,L25,6HN,38,18,20,16
L25 6HP,L25,6HP,11,6,5,8
L25 6HQ,L25,6HQ,38,23,15,18
L25 6HR,L25,6HR,76,37,39,32
L25 6HS,L25,6HS,2,1,1,1
L25 6HT,L25,6HT,16,6,10,6
L25 6HU,L25,6HU,79,43,36,25
L25 6HW,L25,6HW,33,14,19,16
L25 6HX,L25,6HX,14,7,7,5
L25 6HY,L25,6HY,60,29,31,21
L25 6HZ,L25,6HZ,39,14,25,12
L25 6JA,L25,6JA,5,3,2,2
L25 6JB,L25,6JB,77,42,35,25
L25 6JD,L25,6JD,28,13,15,9
L25 6JE,L25,6JE,35,18,17,11
L25 6JF,L25,6JF,40,20,20,16
L25 6JG,L25,6JG,25,11,14,9
L25 6JJ,L25,6JJ,14,7,7,6
L25 6JL,L25,6JL,9,5,4,6
L25 6JN,L25,6JN,29,16,13,23
L25 6JP,L25,6JP,23,13,10,9
L25 6JQ,L25,6JQ,50,20,30,20
L25 6JR,L25,6JR,20,8,12,11
L25 6JW,L25,6JW,26,15,11,11
L25 6JX,L25,6JX,61,29,32,23
L25 6JY,L25,6JY,36,17,19,12
L25 6JZ,L25,6JZ,36,15,21,14
L25 6LB,L25,6LB,16,9,7,8
L25 6LD,L25,6LD,25,12,13,17
L25 6LE,L25,6LE,17,7,10,9
L25 6LF,L25,6LF,64,38,26,19
L25 6LG,L25,6LG,13,7,6,12
L25 6LP,L25,6LP,27,12,15,17
L25 6LY,L25,6LY,27,15,12,19
L25 7AB,L25,7AB,50,24,26,15
L25 7AE,L25,7AE,15,6,9,13
L25 7AJ,L25,7AJ,35,13,22,27
L25 7AQ,L25,7AQ,50,28,22,19
L25 7AY,L25,7AY,59,27,32,24
L25 7BG,L25,7BG,62,37,25,26
L25 7DA,L25,7DA,20,7,13,6
L25 7DB,L25,7DB,13,7,6,5
L25 7DD,L25,7DD,15,8,7,7
L25 7FB,L25,7FB,39,11,28,38
L25 7GA,L25,7GA,20,10,10,8
L25 7GB,L25,7GB,12,4,8,5
L25 7RA,L25,7RA,4,3,1,3
L25 7RE,L25,7RE,18,11,7,15
L25 7RF,L25,7RF,18,7,11,8
L25 7RG,L25,7RG,6,2,4,5
L25 7RH,L25,7RH,45,21,24,24
L25 7RJ,L25,7RJ,3,2,1,3
L25 7RL,L25,7RL,30,16,14,19
L25 7RN,L25,7RN,62,31,31,23
L25 7RP,L25,7RP,12,4,8,9
L25 7RQ,L25,7RQ,34,17,17,17
L25 7RR,L25,7RR,20,9,11,11
L25 7RS,L25,7RS,13,9,4,8
L25 7RT,L25,7RT,27,15,12,17
L25 7RU,L25,7RU,26,15,11,17
L25 7RW,L25,7RW,49,21,28,23
L25 7RX,L25,7RX,22,11,11,13
L25 7RY,L25,7RY,24,13,11,16
L25 7RZ,L25,7RZ,46,18,28,37
L25 7SA,L25,7SA,47,24,23,20
L25 7SE,L25,7SE,48,28,20,24
L25 7SG,L25,7SG,52,25,27,25
L25 7SL,L25,7SL,22,11,11,11
L25 7SN,L25,7SN,72,33,39,38
L25 7SP,L25,7SP,3,1,2,2
L25 7SQ,L25,7SQ,70,35,35,30
L25 7SR,L25,7SR,10,6,4,3
L25 7SS,L25,7SS,41,15,26,25
L25 7SW,L25,7SW,57,28,29,32
L25 7SY,L25,7SY,27,13,14,18
L25 7SZ,L25,7SZ,2,2,0,2
L25 7TA,L25,7TA,8,6,2,8
L25 7TB,L25,7TB,53,11,42,0
L25 7TD,L25,7TD,5,3,2,3
L25 7TE,L25,7TE,72,37,35,23
L25 7TF,L25,7TF,22,11,11,11
L25 7TG,L25,7TG,20,9,11,13
L25 7TH,L25,7TH,2,1,1,1
L25 7TJ,L25,7TJ,6,3,3,4
L25 7TL,L25,7TL,19,9,10,10
L25 7TQ,L25,7TQ,32,17,15,29
L25 7TR,L25,7TR,12,5,7,7
L25 7TS,L25,7TS,130,68,62,52
L25 7TT,L25,7TT,72,32,40,28
L25 7TU,L25,7TU,72,30,42,29
L25 7TW,L25,7TW,39,18,21,12
L25 7TX,L25,7TX,56,31,25,23
L25 7TY,L25,7TY,14,7,7,5
L25 7TZ,L25,7TZ,3,2,1,2
L25 7UA,L25,7UA,10,6,4,5
L25 7UB,L25,7UB,65,25,40,60
L25 7UD,L25,7UD,73,39,34,27
L25 7UE,L25,7UE,52,28,24,22
L25 7UF,L25,7UF,14,7,7,7
L25 7UG,L25,7UG,51,31,20,23
L25 7UH,L25,7UH,63,32,31,28
L25 7UJ,L25,7UJ,50,24,26,21
L25 7UL,L25,7UL,57,29,28,12
L25 7UN,L25,7UN,26,14,12,12
L25 7UQ,L25,7UQ,32,10,22,16
L25 7UR,L25,7UR,46,23,23,37
L25 7US,L25,7US,47,25,22,35
L25 7UT,L25,7UT,49,25,24,37
L25 7UU,L25,7UU,46,23,23,36
L25 7UW,L25,7UW,63,10,53,0
L25 7UX,L25,7UX,56,30,26,44
L25 7UY,L25,7UY,57,28,29,46
L25 7UZ,L25,7UZ,57,31,26,45
L25 7XA,L25,7XA,60,38,22,46
L25 7XB,L25,7XB,19,10,9,17
L25 7XE,L25,7XE,103,52,51,39
L25 7XH,L25,7XH,45,21,24,18
L25 7XJ,L25,7XJ,48,23,25,36
L25 7XQ,L25,7XQ,39,20,19,13
L25 7XR,L25,7XR,70,28,42,48
L25 7YD,L25,7YD,103,53,50,31
L25 7YE,L25,7YE,133,65,68,40
L25 7YF,L25,7YF,42,20,22,11
L25 7YH,L25,7YH,4,1,3,1
L25 7YL,L25,7YL,27,13,14,15
L25 7YN,L25,7YN,15,8,7,6
L25 7YQ,L25,7YQ,56,30,26,19
L25 8QA,L25,8QA,11,7,4,3
L25 8QB,L25,8QB,15,8,7,11
L25 8QD,L25,8QD,18,7,11,10
L25 8QE,L25,8QE,54,21,33,24
L25 8QF,L25,8QF,29,15,14,11
L25 8QG,L25,8QG,34,16,18,16
L25 8QH,L25,8QH,44,21,23,17
L25 8QJ,L25,8QJ,31,12,19,12
L25 8QL,L25,8QL,23,13,10,13
L25 8QN,L25,8QN,17,7,10,8
L25 8QP,L25,8QP,19,8,11,10
L25 8QQ,L25,8QQ,34,17,17,13
L25 8QR,L25,8QR,20,7,13,14
L25 8QS,L25,8QS,84,44,40,36
L25 8QT,L25,8QT,70,36,34,33
L25 8QU,L25,8QU,48,24,24,20
L25 8QW,L25,8QW,32,12,20,17
L25 8QX,L25,8QX,26,9,17,13
L25 8QY,L25,8QY,37,21,16,15
L25 8QZ,L25,8QZ,29,13,16,15
L25 8RA,L25,8RA,69,38,31,28
L25 8RB,L25,8RB,38,15,23,16
L25 8RD,L25,8RD,37,18,19,14
L25 8RE,L25,8RE,73,40,33,24
L25 8RF,L25,8RF,50,25,25,18
L25 8RG,L25,8RG,65,35,30,31
L25 8RH,L25,8RH,95,46,49,38
L25 8RL,L25,8RL,55,25,30,22
L25 8RN,L25,8RN,20,11,9,10
L25 8RQ,L25,8RQ,39,21,18,17
L25 8RR,L25,8RR,36,23,13,15
L25 8RS,L25,8RS,23,9,14,11
L25 8RT,L25,8RT,40,17,23,12
L25 8RU,L25,8RU,74,37,37,33
L25 8RW,L25,8RW,50,20,30,20
L25 8RX,L25,8RX,46,20,26,16
L25 8RY,L25,8RY,68,33,35,39
L25 8RZ,L25,8RZ,35,15,20,15
L25 8SA,L25,8SA,52,23,29,22
L25 8SB,L25,8SB,36,15,21,17
L25 8SD,L25,8SD,34,20,14,28
L25 8SE,L25,8SE,56,30,26,26
L25 8SF,L25,8SF,41,19,22,17
L25 8SH,L25,8SH,20,8,12,9
L25 8SJ,L25,8SJ,26,15,11,10
L25 8SL,L25,8SL,46,22,24,22
L25 8SN,L25,8SN,36,14,22,22
L25 8SP,L25,8SP,59,26,33,25
L25 8SQ,L25,8SQ,49,32,17,36
L25 8SR,L25,8SR,66,26,40,34
L25 8SS,L25,8SS,58,22,36,25
L25 8ST,L25,8ST,48,23,25,25
L25 8SU,L25,8SU,66,30,36,30
L25 8SW,L25,8SW,53,23,30,24
L25 8SX,L25,8SX,26,11,15,14
L25 8SY,L25,8SY,33,17,16,13
L25 8SZ,L25,8SZ,49,26,23,17
L25 8TA,L25,8TA,72,39,33,33
L25 8TB,L25,8TB,75,36,39,30
L25 8TD,L25,8TD,13,6,7,5
L25 8TE,L25,8TE,85,42,43,31
L25 8TF,L25,8TF,71,36,35,30
L25 8TG,L25,8TG,46,23,23,17
L25 8TH,L25,8TH,39,17,22,20
L25 8TJ,L25,8TJ,31,14,17,17
L25 8TL,L25,8TL,87,42,45,39
L25 8TN,L25,8TN,66,32,34,30
L25 8TP,L25,8TP,97,49,48,41
L25 8TQ,L25,8TQ,61,34,27,28
L25 8TR,L25,8TR,33,14,19,27
L25 8TS,L25,8TS,75,27,48,59
L25 8TT,L25,8TT,42,15,27,36
L25 8TU,L25,8TU,63,27,36,23
L25 8TW,L25,8TW,35,14,21,15
L25 8UB,L25,8UB,21,6,15,12
L25 9GA,L25,9GA,8,4,4,4
L25 9GB,L25,9GB,12,5,7,5
L25 9GD,L25,9GD,136,58,78,63
L25 9GE,L25,9GE,28,12,16,11
L25 9GF,L25,9GF,76,37,39,33
L25 9GG,L25,9GG,65,31,34,28
L25 9GH,L25,9GH,13,7,6,4
L25 9LR,L25,9LR,15,4,11,5
L25 9LS,L25,9LS,29,12,17,12
L25 9NA,L25,9NA,48,16,32,19
L25 9NB,L25,9NB,61,35,26,23
L25 9ND,L25,9ND,59,24,35,24
L25 9NE,L25,9NE,71,33,38,30
L25 9NF,L25,9NF,54,22,32,24
L25 9NG,L25,9NG,56,28,28,24
L25 9NH,L25,9NH,66,32,34,29
L25 9NJ,L25,9NJ,44,21,23,22
L25 9NL,L25,9NL,19,9,10,6
L25 9NN,L25,9NN,81,43,38,28
L25 9NP,L25,9NP,56,23,33,19
L25 9NQ,L25,9NQ,47,20,27,18
L25 9NR,L25,9NR,82,43,39,31
L25 9NS,L25,9NS,91,47,44,41
L25 9NT,L25,9NT,72,40,32,28
L25 9NU,L25,9NU,55,23,32,26
L25 9NW,L25,9NW,42,19,23,18
L25 9NX,L25,9NX,57,20,37,26
L25 9NY,L25,9NY,95,40,55,37
L25 9NZ,L25,9NZ,42,22,20,20
L25 9PA,L25,9PA,71,29,42,17
L25 9PB,L25,9PB,41,21,20,21
L25 9PD,L25,9PD,60,27,33,35
L25 9PE,L25,9PE,56,30,26,26
L25 9PF,L25,9PF,41,20,21,21
L25 9PG,L25,9PG,51,30,21,26
L25 9PH,L25,9PH,43,22,21,22
L25 9PJ,L25,9PJ,71,34,37,32
L25 9PL,L25,9PL,54,25,29,26
L25 9PN,L25,9PN,50,19,31,24
L25 9PP,L25,9PP,34,21,13,17
L25 9PQ,L25,9PQ,61,32,29,24
L25 9PR,L25,9PR,32,12,20,19
L25 9PT,L25,9PT,26,10,16,9
L25 9PU,L25,9PU,16,8,8,8
L25 9PW,L25,9PW,30,17,13,15
L25 9PX,L25,9PX,13,7,6,6
L25 9PY,L25,9PY,22,8,14,8
L25 9PZ,L25,9PZ,57,22,35,34
L25 9QA,L25,9QA,55,19,36,22
L25 9QB,L25,9QB,26,14,12,14
L25 9QD,L25,9QD,32,15,17,17
L25 9QE,L25,9QE,58,21,37,25
L25 9QF,L25,9QF,132,44,88,5
L25 9QG,L25,9QG,15,7,8,12
L25 9QH,L25,9QH,51,20,31,18
L25 9QJ,L25,9QJ,19,7,12,7
L25 9QN,L25,9QN,42,20,22,18
L25 9QP,L25,9QP,30,17,13,20
L25 9QQ,L25,9QQ,21,10,11,11
L25 9QR,L25,9QR,17,9,8,14
L25 9QS,L25,9QS,37,20,17,20
L25 9QT,L25,9QT,47,24,23,17
L25 9QU,L25,9QU,46,21,25,25
L25 9QW,L25,9QW,34,17,17,13
L25 9QX,L25,9QX,45,21,24,25
L25 9QY,L25,9QY,58,33,25,28
L25 9QZ,L25,9QZ,29,13,16,14
L25 9RA,L25,9RA,40,18,22,19
L25 9RB,L25,9RB,51,23,28,26
L25 9RD,L25,9RD,28,11,17,12
L25 9RE,L25,9RE,18,8,10,6
L25 9RH,L25,9RH,18,11,7,8
L25 9RJ,L25,9RJ,46,22,24,25
L25 9RL,L25,9RL,59,31,28,48
L25 9RN,L25,9RN,64,36,28,48
L25 9RT,L25,9RT,51,25,26,21
L25 9RU,L25,9RU,151,74,77,61
L25 9RW,L25,9RW,60,30,30,47
L25 9RX,L25,9RX,4,1,3,3
L25 9RY,L25,9RY,65,31,34,30
L25 9RZ,L25,9RZ,60,29,31,24
L25 9SA,L25,9SA,8,3,5,4
L25 9SB,L25,9SB,148,71,77,66
L25 9SD,L25,9SD,32,12,20,12
L25 9SE,L25,9SE,85,43,42,27
L25 9SF,L25,9SF,24,10,14,10
L25 9SN,L25,9SN,83,44,39,32
L25 9SS,L25,9SS,16,6,10,10
L25 9ST,L25,9ST,45,17,28,21
L25 9SU,L25,9SU,26,9,17,11
L25 9SX,L25,9SX,52,23,29,20
L25 9TA,L25,9TA,25,10,15,10
L26 0SU,L26,0SU,46,19,27,29
L26 0SX,L26,0SX,5,2,3,5
L26 0SY,L26,0SY,98,47,51,42
L26 0SZ,L26,0SZ,18,9,9,12
L26 0TA,L26,0TA,11,4,7,3
L26 0TB,L26,0TB,21,10,11,10
L26 0TD,L26,0TD,19,8,11,12
L26 0TE,L26,0TE,80,37,43,35
L26 0TF,L26,0TF,25,12,13,9
L26 0TG,L26,0TG,43,27,16,17
L26 0TH,L26,0TH,6,3,3,3
L26 0TJ,L26,0TJ,23,12,11,15
L26 0TL,L26,0TL,95,44,51,38
L26 0TN,L26,0TN,72,36,36,28
L26 0TP,L26,0TP,88,46,42,40
L26 0TQ,L26,0TQ,46,25,21,19
L26 0TR,L26,0TR,85,40,45,31
L26 0TT,L26,0TT,56,29,27,20
L26 0TU,L26,0TU,55,33,22,19
L26 0TW,L26,0TW,79,39,40,40
L26 0TX,L26,0TX,42,21,21,22
L26 0TY,L26,0TY,70,30,40,27
L26 0TZ,L26,0TZ,30,12,18,13
L26 0UA,L26,0UA,50,24,26,23
L26 0UB,L26,0UB,49,21,28,22
L26 0UD,L26,0UD,22,8,14,10
L26 0UE,L26,0UE,65,34,31,29
L26 0UF,L26,0UF,40,20,20,22
L26 0UG,L26,0UG,73,30,43,36
L26 0UH,L26,0UH,30,13,17,14
L26 0UJ,L26,0UJ,19,10,9,8
L26 0UL,L26,0UL,49,24,25,18
L26 0UQ,L26,0UQ,59,26,33,29
L26 0US,L26,0US,37,15,22,19
L26 0UT,L26,0UT,13,9,4,5
L26 0UU,L26,0UU,59,28,31,24
L26 0UX,L26,0UX,83,35,48,32
L26 0UY,L26,0UY,49,27,22,17
L26 0UZ,L26,0UZ,60,30,30,25
L26 0XA,L26,0XA,24,13,11,8
L26 0XB,L26,0XB,39,19,20,14
L26 0XD,L26,0XD,21,11,10,8
L26 0XE,L26,0XE,87,40,47,34
L26 0XG,L26,0XG,100,52,48,38
L26 0XH,L26,0XH,94,42,52,40
L26 0XQ,L26,0XQ,106,54,52,44
L26 1TA,L26,1TA,15,5,10,8
L26 1TB,L26,1TB,33,15,18,17
L26 1TD,L26,1TD,16,8,8,6
L26 1TE,L26,1TE,73,40,33,26
L26 1TF,L26,1TF,47,27,20,23
L26 1TG,L26,1TG,90,49,41,40
L26 1TH,L26,1TH,31,14,17,14
L26 1TJ,L26,1TJ,18,10,8,6
L26 1TN,L26,1TN,110,51,59,42
L26 1TP,L26,1TP,87,42,45,41
L26 1TQ,L26,1TQ,41,22,19,15
L26 1TR,L26,1TR,85,36,49,28
L26 1TS,L26,1TS,64,35,29,23
L26 1TT,L26,1TT,14,6,8,6
L26 1TU,L26,1TU,45,24,21,21
L26 1TW,L26,1TW,36,14,22,16
L26 1TX,L26,1TX,32,17,15,23
L26 1TY,L26,1TY,69,32,37,33
L26 1TZ,L26,1TZ,25,8,17,11
L26 1UA,L26,1UA,102,46,56,43
L26 1UB,L26,1UB,24,11,13,13
L26 1UD,L26,1UD,38,20,18,15
L26 1UE,L26,1UE,66,30,36,32
L26 1UF,L26,1UF,44,21,23,32
L26 1UG,L26,1UG,60,37,23,31
L26 1UH,L26,1UH,11,7,4,8
L26 1UJ,L26,1UJ,11,5,6,7
L26 1UL,L26,1UL,37,16,21,18
L26 1UN,L26,1UN,82,38,44,35
L26 1UP,L26,1UP,43,16,27,17
L26 1UQ,L26,1UQ,83,42,41,37
L26 1UR,L26,1UR,40,17,23,19
L26 1US,L26,1US,33,10,23,12
L26 1UT,L26,1UT,4,3,1,3
L26 1UU,L26,1UU,23,10,13,7
L26 1UW,L26,1UW,97,44,53,44
L26 1UX,L26,1UX,109,53,56,54
L26 1UY,L26,1UY,28,15,13,14
L26 1UZ,L26,1UZ,32,17,15,14
L26 1XA,L26,1XA,102,51,51,44
L26 1XB,L26,1XB,95,44,51,38
L26 1XD,L26,1XD,103,48,55,45
L26 1XE,L26,1XE,107,51,56,42
L26 1XF,L26,1XF,118,62,56,47
L26 1XG,L26,1XG,39,17,22,17
L26 1XH,L26,1XH,110,55,55,47
L26 1XJ,L26,1XJ,10,6,4,3
L26 1XL,L26,1XL,44,23,21,14
L26 1XN,L26,1XN,78,34,44,32
L26 1XQ,L26,1XQ,48,21,27,17
L26 1XT,L26,1XT,62,26,36,25
L26 1XU,L26,1XU,25,13,12,9
L26 1XW,L26,1XW,9,3,6,8
L26 1XX,L26,1XX,46,20,26,16
L26 1XY,L26,1XY,57,28,29,21
L26 1YB,L26,1YB,16,8,8,10
L26 1YD,L26,1YD,13,6,7,8
L26 1YE,L26,1YE,27,16,11,10
L26 1YF,L26,1YF,40,19,21,16
L26 1YG,L26,1YG,33,17,16,15
L26 1YQ,L26,1YQ,49,22,27,25
L26 2XA,L26,2XA,57,23,34,24
L26 2XB,L26,2XB,50,25,25,20
L26 2XD,L26,2XD,85,42,43,42
L26 2XE,L26,2XE,19,8,11,13
L26 3UA,L26,3UA,16,7,9,7
L26 3UB,L26,3UB,13,8,5,4
L26 3UD,L26,3UD,59,32,27,44
L26 3UE,L26,3UE,5,3,2,2
L26 4XA,L26,4XA,8,4,4,2
L26 4XE,L26,4XE,2,1,1,2
L26 4XF,L26,4XF,20,9,11,7
L26 4XG,L26,4XG,13,9,4,4
L26 5QA,L26,5QA,5,3,2,3
L26 5QB,L26,5QB,18,9,9,8
L26 6BA,L26,6BA,192,86,106,62
L26 6BB,L26,6BB,60,28,32,19
L26 6BD,L26,6BD,16,7,9,5
L26 6BE,L26,6BE,87,44,43,26
L26 6BF,L26,6BF,47,24,23,14
L26 6BG,L26,6BG,17,7,10,5
L26 6BH,L26,6BH,26,11,15,9
L26 6BJ,L26,6BJ,27,13,14,11
L26 6BL,L26,6BL,45,23,22,12
L26 6BN,L26,6BN,66,29,37,37
L26 6BP,L26,6BP,50,20,30,16
L26 6BQ,L26,6BQ,26,15,11,12
L26 6BR,L26,6BR,34,19,15,12
L26 6LA,L26,6LA,16,6,10,8
L26 6LB,L26,6LB,35,17,18,13
L26 6LD,L26,6LD,50,27,23,21
L26 6LE,L26,6LE,13,6,7,6
L26 6LJ,L26,6LJ,20,10,10,6
L26 6LN,L26,6LN,165,80,85,52
L26 6LP,L26,6LP,69,32,37,21
L26 6LR,L26,6LR,40,20,20,12
L26 6LS,L26,6LS,34,16,18,10
L26 6LT,L26,6LT,36,19,17,15
L26 6LU,L26,6LU,67,35,32,19
L26 6LW,L26,6LW,67,34,33,23
L26 6LX,L26,6LX,74,39,35,21
L26 6LY,L26,6LY,26,11,15,8
L26 6NA,L26,6NA,52,31,21,17
L26 6NB,L26,6NB,20,8,12,8
L26 6ND,L26,6ND,21,9,12,6
L26 7AA,L26,7AA,161,90,71,55
L26 7AB,L26,7AB,52,26,26,17
L26 7AD,L26,7AD,71,36,35,27
L26 7AE,L26,7AE,46,25,21,15
L26 7AG,L26,7AG,182,93,89,91
L26 7AH,L26,7AH,32,15,17,14
L26 7AJ,L26,7AJ,45,22,23,18
L26 7AL,L26,7AL,32,17,15,11
L26 7AN,L26,7AN,93,41,52,43
L26 7AP,L26,7AP,42,19,23,18
L26 7AQ,L26,7AQ,38,20,18,17
L26 7AR,L26,7AR,48,23,25,18
L26 7AW,L26,7AW,22,8,14,12
L26 7UQ,L26,7UQ,43,22,21,14
L26 7UR,L26,7UR,37,18,19,14
L26 7WE,L26,7WE,87,47,40,33
L26 7WF,L26,7WF,14,5,9,7
L26 7WG,L26,7WG,51,22,29,20
L26 7WH,L26,7WH,54,29,25,22
L26 7WJ,L26,7WJ,13,8,5,6
L26 7WN,L26,7WN,17,7,10,8
L26 7WP,L26,7WP,121,57,64,45
L26 7WQ,L26,7WQ,69,32,37,31
L26 7WR,L26,7WR,63,29,34,24
L26 7WS,L26,7WS,94,51,43,32
L26 7WT,L26,7WT,58,26,32,18
L26 7WU,L26,7WU,20,11,9,6
L26 7WW,L26,7WW,19,9,10,6
L26 7WX,L26,7WX,70,38,32,25
L26 7WY,L26,7WY,21,13,8,8
L26 7WZ,L26,7WZ,30,16,14,9
L26 7XD,L26,7XD,53,28,25,17
L26 7XE,L26,7XE,76,38,38,23
L26 7XF,L26,7XF,31,17,14,9
L26 7XG,L26,7XG,61,29,32,21
L26 7XH,L26,7XH,60,33,27,21
L26 7XJ,L26,7XJ,64,31,33,20
L26 7XN,L26,7XN,26,15,11,8
L26 7XP,L26,7XP,11,4,7,5
L26 7XQ,L26,7XQ,33,17,16,10
L26 7XR,L26,7XR,19,11,8,5
L26 7XS,L26,7XS,28,14,14,7
L26 7XT,L26,7XT,37,20,17,12
L26 7XU,L26,7XU,70,32,38,21
L26 7XW,L26,7XW,34,15,19,9
L26 7XX,L26,7XX,68,34,34,20
L26 7XY,L26,7XY,42,20,22,15
L26 7XZ,L26,7XZ,47,25,22,14
L26 7YA,L26,7YA,51,24,27,20
L26 7YB,L26,7YB,62,30,32,30
L26 7YD,L26,7YD,49,29,20,18
L26 7YE,L26,7YE,8,4,4,2
L26 7YF,L26,7YF,34,15,19,18
L26 7YG,L26,7YG,55,27,28,23
L26 7YH,L26,7YH,33,18,15,13
L26 7YJ,L26,7YJ,43,19,24,17
L26 7YL,L26,7YL,12,5,7,6
L26 7YN,L26,7YN,118,61,57,43
L26 7YP,L26,7YP,141,64,77,59
L26 7YQ,L26,7YQ,62,30,32,23
L26 7YR,L26,7YR,141,77,64,50
L26 7YS,L26,7YS,95,44,51,39
L26 7YT,L26,7YT,61,31,30,22
L26 7YU,L26,7YU,124,60,64,44
L26 7YW,L26,7YW,163,86,77,62
L26 7YX,L26,7YX,108,50,58,38
L26 7YY,L26,7YY,43,23,20,18
L26 7YZ,L26,7YZ,35,22,13,16
L26 7ZB,L26,7ZB,162,79,83,68
L26 7ZD,L26,7ZD,52,24,28,16
L26 7ZE,L26,7ZE,21,9,12,9
L26 7ZF,L26,7ZF,14,6,8,6
L26 7ZG,L26,7ZG,21,10,11,6
L26 7ZH,L26,7ZH,42,24,18,18
L26 7ZJ,L26,7ZJ,95,47,48,32
L26 7ZL,L26,7ZL,52,24,28,20
L26 7ZQ,L26,7ZQ,29,14,15,10
L26 7ZR,L26,7ZR,51,17,34,17
L26 7ZS,L26,7ZS,68,31,37,26
L26 7ZT,L26,7ZT,87,41,46,33
L26 7ZU,L26,7ZU,42,16,26,16
L26 7ZX,L26,7ZX,45,21,24,14
L26 7ZY,L26,7ZY,13,6,7,6
L26 7ZZ,L26,7ZZ,24,14,10,10
L26 8UD,L26,8UD,2,1,1,1
L26 9SA,L26,9SA,31,19,12,11
L26 9SB,L26,9SB,27,15,12,10
L26 9SD,L26,9SD,24,14,10,8
L26 9TA,L26,9TA,59,27,32,45
L26 9TB,L26,9TB,93,45,48,43
L26 9TJ,L26,9TJ,47,26,21,22
L26 9TL,L26,9TL,76,38,38,30
L26 9TN,L26,9TN,42,18,24,16
L26 9TP,L26,9TP,55,29,26,25
L26 9TR,L26,9TR,16,7,9,9
L26 9TS,L26,9TS,48,25,23,17
L26 9TU,L26,9TU,63,27,36,21
L26 9TW,L26,9TW,24,8,16,10
L26 9TX,L26,9TX,7,4,3,3
L26 9TY,L26,9TY,8,5,3,4
L26 9TZ,L26,9TZ,21,10,11,14
L26 9UA,L26,9UA,39,23,16,16
L26 9UB,L26,9UB,40,19,21,18
L26 9UD,L26,9UD,73,39,34,34
L26 9UE,L26,9UE,62,28,34,26
L26 9UF,L26,9UF,31,13,18,13
L26 9UG,L26,9UG,63,35,28,24
L26 9UH,L26,9UH,72,39,33,26
L26 9UJ,L26,9UJ,48,24,24,17
L26 9UL,L26,9UL,40,17,23,19
L26 9UN,L26,9UN,81,30,51,32
L26 9UP,L26,9UP,43,26,17,22
L26 9UQ,L26,9UQ,64,31,33,26
L26 9UR,L26,9UR,22,8,14,10
L26 9US,L26,9US,25,7,18,11
L26 9UT,L26,9UT,93,39,54,41
L26 9UU,L26,9UU,56,23,33,25
L26 9UW,L26,9UW,36,16,20,21
L26 9UX,L26,9UX,81,39,42,32
L26 9UY,L26,9UY,57,31,26,26
L26 9UZ,L26,9UZ,52,24,28,24
L26 9WA,L26,9WA,36,14,22,14
L26 9XA,L26,9XA,32,16,16,16
L26 9XB,L26,9XB,61,29,32,25
L26 9XD,L26,9XD,78,35,43,36
L26 9XE,L26,9XE,32,17,15,12
L26 9XF,L26,9XF,22,8,14,12
L26 9XG,L26,9XG,11,5,6,4
L26 9XH,L26,9XH,45,19,26,20
L26 9XL,L26,9XL,88,39,49,25
L26 9XN,L26,9XN,6,2,4,3
L26 9XP,L26,9XP,29,12,17,14
L26 9XQ,L26,9XQ,2,1,1,1
L26 9XR,L26,9XR,59,31,28,22
L26 9XS,L26,9XS,32,13,19,11
L26 9XT,L26,9XT,61,26,35,23
L26 9XU,L26,9XU,29,11,18,12
L26 9XW,L26,9XW,5,3,2,3
L26 9XY,L26,9XY,47,30,17,19
L26 9XZ,L26,9XZ,50,20,30,36
L26 9YA,L26,9YA,54,24,30,25
L26 9YB,L26,9YB,32,19,13,17
L26 9YD,L26,9YD,37,20,17,11
L26 9YE,L26,9YE,52,25,27,19
L26 9YG,L26,9YG,51,24,27,20
L26 9YH,L26,9YH,42,17,25,14
L26 9YJ,L26,9YJ,51,25,26,22
L26 9YL,L26,9YL,50,28,22,15
L26 9YN,L26,9YN,35,20,15,14
L26 9YP,L26,9YP,21,12,9,7
L26 9YQ,L26,9YQ,34,16,18,11
L26 9YS,L26,9YS,107,49,58,38
L26 9YT,L26,9YT,16,7,9,6
L26 9YW,L26,9YW,29,14,15,11
L27 0YE,L27,0YE,172,85,87,71
L27 1XD,L27,1XD,24,11,13,9
L27 1XE,L27,1XE,33,18,15,13
L27 1XF,L27,1XF,39,18,21,17
L27 1XG,L27,1XG,52,26,26,23
L27 1XH,L27,1XH,103,50,53,51
L27 1XJ,L27,1XJ,60,25,35,25
L27 1XL,L27,1XL,63,34,29,32
L27 1XN,L27,1XN,84,38,46,43
L27 1XQ,L27,1XQ,66,31,35,32
L27 1XR,L27,1XR,31,11,20,15
L27 1XS,L27,1XS,28,11,17,12
L27 1XT,L27,1XT,126,57,69,59
L27 1XU,L27,1XU,12,8,4,10
L27 1XX,L27,1XX,47,20,27,21
L27 1XY,L27,1XY,7,4,3,5
L27 1XZ,L27,1XZ,47,21,26,22
L27 1YB,L27,1YB,66,30,36,26
L27 1YH,L27,1YH,22,9,13,14
L27 1YT,L27,1YT,9,5,4,4
L27 1YW,L27,1YW,22,6,16,12
L27 1YX,L27,1YX,77,25,52,67
L27 1YY,L27,1YY,46,14,32,19
L27 1YZ,L27,1YZ,61,24,37,22
L27 2YA,L27,2YA,21,9,12,7
L27 3YA,L27,3YA,6,3,3,2
L27 4BA,L27,4BA,9,3,6,6
L27 4BB,L27,4BB,31,12,19,18
L27 4BD,L27,4BD,43,25,18,17
L27 4BE,L27,4BE,25,9,16,15
L27 4BF,L27,4BF,49,25,24,21
L27 4BG,L27,4BG,12,7,5,4
L27 4BH,L27,4BH,29,15,14,12
L27 4BJ,L27,4BJ,12,6,6,7
L27 4XU,L27,4XU,4,2,2,3
L27 4XX,L27,4XX,22,7,15,14
L27 4XY,L27,4XY,35,14,21,11
L27 4XZ,L27,4XZ,62,29,33,18
L27 4YA,L27,4YA,29,14,15,0
L27 4YE,L27,4YE,16,9,7,6
L27 5QN,L27,5QN,19,6,13,7
L27 5QP,L27,5QP,9,4,5,5
L27 5QW,L27,5QW,12,5,7,4
L27 5RA,L27,5RA,8,2,6,5
L27 5RB,L27,5RB,105,44,61,40
L27 5RD,L27,5RD,28,14,14,8
L27 5RE,L27,5RE,66,32,34,24
L27 5RF,L27,5RF,108,55,53,38
L27 5RG,L27,5RG,30,11,19,12
L27 5RH,L27,5RH,55,27,28,22
L27 5RJ,L27,5RJ,73,34,39,31
L27 5RL,L27,5RL,134,61,73,44
L27 5RN,L27,5RN,103,44,59,33
L27 5RP,L27,5RP,51,23,28,20
L27 5RQ,L27,5RQ,79,41,38,38
L27 5RR,L27,5RR,59,22,37,25
L27 5RS,L27,5RS,12,4,8,5
L27 5RT,L27,5RT,85,36,49,32
L27 5RU,L27,5RU,42,22,20,14
L27 5RW,L27,5RW,86,38,48,35
L27 5RX,L27,5RX,35,15,20,15
L27 5RY,L27,5RY,32,18,14,14
L27 5RZ,L27,5RZ,16,7,9,7
L27 6PA,L27,6PA,9,5,4,5
L27 6PB,L27,6PB,63,31,32,26
L27 6PD,L27,6PD,20,9,11,6
L27 6PE,L27,6PE,55,24,31,27
L27 6PF,L27,6PF,33,19,14,16
L27 6PG,L27,6PG,59,27,32,23
L27 6PH,L27,6PH,44,14,30,21
L27 6PJ,L27,6PJ,41,17,24,18
L27 6PL,L27,6PL,31,11,20,12
L27 6PN,L27,6PN,17,6,11,9
L27 6PQ,L27,6PQ,31,17,14,13
L27 6PW,L27,6PW,4,2,2,2
L27 6PY,L27,6PY,32,13,19,15
L27 6PZ,L27,6PZ,36,18,18,14
L27 6WA,L27,6WA,42,18,24,24
L27 6WB,L27,6WB,58,24,34,24
L27 6WD,L27,6WD,42,22,20,17
L27 6WE,L27,6WE,36,12,24,13
L27 6WF,L27,6WF,40,17,23,12
L27 6WG,L27,6WG,37,15,22,16
L27 6WH,L27,6WH,71,37,34,33
L27 6WJ,L27,6WJ,34,16,18,13
L27 6WL,L27,6WL,21,8,13,10
L27 6WN,L27,6WN,22,13,9,8
L27 6WQ,L27,6WQ,25,10,15,12
L27 6WW,L27,6WW,112,54,58,47
L27 7AD,L27,7AD,40,21,19,16
L27 7AE,L27,7AE,92,41,51,41
L27 7AH,L27,7AH,54,27,27,32
L27 7AJ,L27,7AJ,114,49,65,48
L27 7AL,L27,7AL,67,34,33,24
L27 7AN,L27,7AN,43,18,25,23
L27 7AR,L27,7AR,50,10,40,1
L27 7AU,L27,7AU,38,19,19,21
L27 7AW,L27,7AW,40,18,22,17
L27 7BB,L27,7BB,72,32,40,34
L27 7BD,L27,7BD,20,6,14,8
L27 7BE,L27,7BE,38,15,23,17
L27 7BG,L27,7BG,34,20,14,10
L27 7BH,L27,7BH,58,29,29,24
L27 7BJ,L27,7BJ,20,9,11,6
L27 7BL,L27,7BL,103,46,57,42
L27 7BN,L27,7BN,111,47,64,46
L27 7BP,L27,7BP,65,27,38,22
L27 7BQ,L27,7BQ,17,13,4,10
L27 7BR,L27,7BR,46,22,24,17
L27 7BS,L27,7BS,56,27,29,31
L27 7BT,L27,7BT,31,13,18,21
L27 7BW,L27,7BW,81,36,45,31
L27 7DA,L27,7DA,42,20,22,20
L27 7DB,L27,7DB,68,33,35,31
L27 7DD,L27,7DD,69,29,40,34
L27 7DE,L27,7DE,42,19,23,17
L27 7DF,L27,7DF,25,7,18,11
L27 7DG,L27,7DG,23,11,12,11
L27 8XJ,L27,8XJ,48,24,24,24
L27 8XL,L27,8XL,73,40,33,34
L27 8XN,L27,8XN,60,24,36,31
L27 8XP,L27,8XP,6,2,4,3
L27 8XR,L27,8XR,34,16,18,19
L27 8XS,L27,8XS,44,22,22,17
L27 8XT,L27,8XT,73,36,37,29
L27 8XU,L27,8XU,12,5,7,7
L27 8XW,L27,8XW,68,30,38,31
L27 8XX,L27,8XX,94,39,55,42
L27 8XY,L27,8XY,30,15,15,10
L27 8XZ,L27,8XZ,143,65,78,56
L27 8YG,L27,8YG,19,11,8,16
L27 8YL,L27,8YL,60,32,28,23
L27 8YN,L27,8YN,31,13,18,14
L27 8YP,L27,8YP,23,14,9,10
L27 8YR,L27,8YR,41,16,25,16
L27 8YW,L27,8YW,33,14,19,11
L28 0QA,L28,0QA,32,15,17,13
L28 0QB,L28,0QB,108,48,60,49
L28 0QD,L28,0QD,31,16,15,13
L28 0QE,L28,0QE,96,43,53,44
L28 0QF,L28,0QF,22,11,11,9
L28 0QG,L28,0QG,81,37,44,32
L28 0QH,L28,0QH,47,20,27,21
L28 0QJ,L28,0QJ,77,36,41,36
L28 0QL,L28,0QL,103,41,62,42
L28 0QP,L28,0QP,44,20,24,18
L28 0QQ,L28,0QQ,91,41,50,35
L28 0QR,L28,0QR,62,32,30,30
L28 0QT,L28,0QT,37,21,16,12
L28 0QU,L28,0QU,39,16,23,15
L28 1NS,L28,1NS,62,33,29,39
L28 1NT,L28,1NT,133,63,70,70
L28 1NU,L28,1NU,21,11,10,11
L28 1NX,L28,1NX,77,33,44,47
L28 1NY,L28,1NY,92,40,52,42
L28 1RA,L28,1RA,64,23,41,32
L28 1RB,L28,1RB,111,49,62,46
L28 1RD,L28,1RD,45,21,24,22
L28 1RF,L28,1RF,164,83,81,55
L28 1RG,L28,1RG,71,30,41,24
L28 1RH,L28,1RH,45,24,21,20
L28 1RJ,L28,1RJ,117,54,63,47
L28 1RL,L28,1RL,28,12,16,13
L28 1RN,L28,1RN,115,54,61,51
L28 1RP,L28,1RP,76,31,45,30
L28 1RQ,L28,1RQ,88,39,49,38
L28 1RW,L28,1RW,52,25,27,27
L28 1SA,L28,1SA,82,34,48,40
L28 1SB,L28,1SB,91,41,50,40
L28 1SD,L28,1SD,113,56,57,60
L28 1SY,L28,1SY,36,12,24,30
L28 1SZ,L28,1SZ,21,12,9,18
L28 3QA,L28,3QA,12,6,6,4
L28 3QB,L28,3QB,57,28,29,26
L28 3QD,L28,3QD,52,30,22,18
L28 3QE,L28,3QE,26,14,12,11
L28 4EA,L28,4EA,78,45,33,34
L28 4EB,L28,4EB,89,47,42,36
L28 4ED,L28,4ED,106,52,54,44
L28 4EE,L28,4EE,100,40,60,35
L28 4EF,L28,4EF,125,50,75,53
L28 4EG,L28,4EG,64,30,34,24
L28 4EH,L28,4EH,94,42,52,39
L28 4EJ,L28,4EJ,53,23,30,20
L28 4EL,L28,4EL,97,46,51,38
L28 4EN,L28,4EN,69,33,36,30
L28 4EP,L28,4EP,92,43,49,34
L28 4EQ,L28,4EQ,52,22,30,22
L28 4ER,L28,4ER,87,36,51,37
L28 4ET,L28,4ET,7,3,4,2
L28 4EW,L28,4EW,68,31,37,30
L28 4EX,L28,4EX,24,10,14,7
L28 5RD,L28,5RD,46,32,14,43
L28 5RE,L28,5RE,55,33,22,44
L28 5RF,L28,5RF,59,33,26,42
L28 5RG,L28,5RG,63,38,25,45
L28 5RH,L28,5RH,77,32,45,37
L28 5RJ,L28,5RJ,91,40,51,41
L28 5RL,L28,5RL,91,47,44,39
L28 5RN,L28,5RN,46,35,11,39
L28 5RP,L28,5RP,39,21,18,33
L28 5RR,L28,5RR,44,27,17,37
L28 5RS,L28,5RS,52,33,19,45
L28 5RT,L28,5RT,54,36,18,44
L28 5RU,L28,5RU,54,20,34,23
L28 5RW,L28,5RW,46,35,11,41
L28 5RX,L28,5RX,63,33,30,25
L28 6YA,L28,6YA,48,25,23,26
L28 6YB,L28,6YB,119,53,66,51
L28 6YD,L28,6YD,42,18,24,21
L28 6YE,L28,6YE,59,25,34,24
L28 6YF,L28,6YF,24,12,12,14
L28 6YH,L28,6YH,61,29,32,28
L28 6YJ,L28,6YJ,25,10,15,12
L28 6YL,L28,6YL,38,16,22,17
L28 6YN,L28,6YN,5,1,4,4
L28 6YQ,L28,6YQ,25,12,13,11
L28 6YW,L28,6YW,12,6,6,6
L28 7RA,L28,7RA,97,46,51,44
L28 7RB,L28,7RB,96,45,51,50
L28 7RD,L28,7RD,91,49,42,46
L28 7RF,L28,7RF,60,33,27,49
L28 7RG,L28,7RG,73,29,44,33
L28 7RH,L28,7RH,47,12,35,18
L28 7RJ,L28,7RJ,19,5,14,7
L28 7RL,L28,7RL,40,20,20,18
L28 7RQ,L28,7RQ,53,20,33,30
L28 8AD,L28,8AD,49,26,23,16
L28 8AE,L28,8AE,64,32,32,25
L28 8AF,L28,8AF,68,30,38,32
L28 8AG,L28,8AG,55,27,28,23
L28 8AH,L28,8AH,116,55,61,40
L28 8AJ,L28,8AJ,115,52,63,50
L28 8AQ,L28,8AQ,69,31,38,29
L29 1YB,L29,1YB,1,0,1,1
L29 3EA,L29,3EA,7,3,4,3
L29 3EB,L29,3EB,6,3,3,2
L29 5XA,L29,5XA,1,0,1,1
L29 5XB,L29,5XB,4,3,1,2
L29 6YA,L29,6YA,1,0,1,1
L29 6YB,L29,6YB,19,8,11,7
L29 6YD,L29,6YD,20,8,12,7
L29 7WA,L29,7WA,16,6,10,8
L29 7WB,L29,7WB,70,38,32,23
L29 7WD,L29,7WD,26,10,16,11
L29 7WE,L29,7WE,27,16,11,12
L29 7WG,L29,7WG,11,4,7,6
L29 7WH,L29,7WH,21,11,10,10
L29 7WJ,L29,7WJ,42,20,22,16
L29 7WL,L29,7WL,15,5,10,8
L29 8YA,L29,8YA,20,9,11,8
L29 8YB,L29,8YB,16,7,9,5
L29 9AD,L29,9AD,40,21,19,11
L29 9AE,L29,9AE,27,14,13,9
L29 9AF,L29,9AF,45,20,25,17
L3  0BG,L3,0BG,107,64,43,71
L3  0BH,L3,0BH,96,52,44,67
L3  0BQ,L3,0BQ,93,64,29,63
L3  0BS,L3,0BS,114,73,41,74
L3  0BT,L3,0BT,84,50,34,57
L3  0BU,L3,0BU,44,31,13,31
L3  1BD,L3,1BD,92,55,37,67
L3  1BF,L3,1BF,86,60,26,61
L3  1BH,L3,1BH,85,50,35,52
L3  1BJ,L3,1BJ,49,31,18,32
L3  1DF,L3,1DF,45,31,14,35
L3  1DJ,L3,1DJ,146,103,43,98
L3  1DS,L3,1DS,2,1,1,1
L3  1DX,L3,1DX,86,45,41,57
L3  1DZ,L3,1DZ,82,54,28,58
L3  1ED,L3,1ED,46,28,18,30
L3  1EJ,L3,1EJ,75,60,15,50
L3  2AP,L3,2AP,23,18,5,11
L3  2AT,L3,2AT,12,5,7,8
L3  2BA,L3,2BA,37,20,17,2
L3  2BB,L3,2BB,70,44,26,37
L3  2BD,L3,2BD,106,68,38,67
L3  2BE,L3,2BE,46,23,23,26
L3  2BL,L3,2BL,20,9,11,12
L3  2BN,L3,2BN,20,12,8,13
L3  2BP,L3,2BP,25,16,9,15
L3  2BS,L3,2BS,18,12,6,9
L3  2BT,L3,2BT,11,3,8,8
L3  2BW,L3,2BW,74,40,34,54
L3  2BX,L3,2BX,684,357,327,13
L3  2BY,L3,2BY,45,13,32,14
L3  2DA,L3,2DA,146,96,50,82
L3  2DB,L3,2DB,128,84,44,75
L3  2DD,L3,2DD,155,98,57,86
L3  2DE,L3,2DE,52,30,22,28
L3  2EL,L3,2EL,21,13,8,13
L3  2EN,L3,2EN,26,12,14,13
L3  2EP,L3,2EP,41,20,21,18
L3  2ER,L3,2ER,46,21,25,17
L3  2ES,L3,2ES,44,29,15,37
L3  2EW,L3,2EW,14,11,3,9
L3  2EZ,L3,2EZ,383,180,203,0
L3  2FB,L3,2FB,11,6,5,9
L3  2HA,L3,2HA,123,82,41,71
L3  2HB,L3,2HB,74,44,30,50
L3  3BU,L3,3BU,3,3,0,2
L3  3BZ,L3,3BZ,15,8,7,8
L3  3DA,L3,3DA,30,20,10,16
L3  3DB,L3,3DB,79,39,40,34
L3  3EG,L3,3EG,1,0,1,1
L3  3EH,L3,3EH,14,5,9,8
L3  3EN,L3,3EN,25,11,14,19
L3  3JB,L3,3JB,41,18,23,18
L3  3JF,L3,3JF,108,54,54,54
L3  3JN,L3,3JN,49,24,25,25
L3  3JP,L3,3JP,60,39,21,43
L3  3JW,L3,3JW,28,11,17,13
L3  4AB,L3,4AB,117,68,49,81
L3  4AG,L3,4AG,31,17,14,22
L3  4AN,L3,4AN,1,0,1,1
L3  4AZ,L3,4AZ,1,0,1,1
L3  4BJ,L3,4BJ,1,1,0,1
L3  4BU,L3,4BU,85,48,37,56
L3  4BW,L3,4BW,89,50,39,55
L3  4DA,L3,4DA,109,67,42,74
L3  4DH,L3,4DH,63,37,26,43
L3  4DN,L3,4DN,86,49,37,46
L3  4DP,L3,4DP,38,22,16,19
L3  4DR,L3,4DR,36,17,19,26
L3  4DT,L3,4DT,10,6,4,10
L3  4DU,L3,4DU,27,14,13,17
L3  4DX,L3,4DX,43,27,16,36
L3  4DY,L3,4DY,32,16,16,21
L3  4EB,L3,4EB,44,27,17,26
L3  4EE,L3,4EE,86,60,26,63
L3  4EF,L3,4EF,99,57,42,68
L3  4EG,L3,4EG,119,68,51,74
L3  4EH,L3,4EH,68,44,24,38
L3  4EJ,L3,4EJ,82,59,23,48
L3  4EL,L3,4EL,91,61,30,54
L3  4EP,L3,4EP,108,59,49,70
L3  4EQ,L3,4EQ,8,5,3,5
L3  4ER,L3,4ER,117,67,50,80
L3  4ES,L3,4ES,81,49,32,55
L3  4ET,L3,4ET,90,57,33,56
L3  4EU,L3,4EU,110,67,43,63
L3  4EW,L3,4EW,109,63,46,62
L3  4EX,L3,4EX,111,75,36,60
L3  4EY,L3,4EY,42,29,13,29
L3  4FB,L3,4FB,120,71,49,75
L3  4FD,L3,4FD,96,57,39,65
L3  4FE,L3,4FE,93,52,41,55
L3  4FF,L3,4FF,97,53,44,64
L3  4FG,L3,4FG,116,68,48,71
L3  4FH,L3,4FH,125,66,59,79
L3  4FN,L3,4FN,3,2,1,1
L3  4FX,L3,4FX,84,49,35,56
L3  5BB,L3,5BB,10,4,6,6
L3  5GA,L3,5GA,1112,475,637,16
L3  5GB,L3,5GB,65,25,40,25
L3  5GD,L3,5GD,31,16,15,21
L3  5GE,L3,5GE,27,17,10,17
L3  5GF,L3,5GF,77,33,44,31
L3  5GG,L3,5GG,56,30,26,28
L3  5LJ,L3,5LJ,84,44,40,43
L3  5LT,L3,5LT,27,14,13,13
L3  5NB,L3,5NB,44,24,20,21
L3  5ND,L3,5ND,21,11,10,17
L3  5NF,L3,5NF,31,25,6,25
L3  5NH,L3,5NH,19,10,9,13
L3  5NL,L3,5NL,12,11,1,10
L3  5NP,L3,5NP,39,20,19,25
L3  5NT,L3,5NT,1,0,1,0
L3  5NX,L3,5NX,324,160,164,0
L3  5NY,L3,5NY,1,0,1,1
L3  5PE,L3,5PE,13,6,7,8
L3  5PH,L3,5PH,123,73,50,54
L3  5PX,L3,5PX,14,7,7,12
L3  5QB,L3,5QB,71,51,20,52
L3  5QF,L3,5QF,22,20,2,15
L3  5QJ,L3,5QJ,162,53,109,0
L3  5QN,L3,5QN,2,1,1,0
L3  5QR,L3,5QR,41,19,22,25
L3  5QS,L3,5QS,15,8,7,6
L3  5QW,L3,5QW,242,109,133,67
L3  5RA,L3,5RA,20,11,9,9
L3  5RB,L3,5RB,38,18,20,16
L3  5RG,L3,5RG,41,20,21,23
L3  5RH,L3,5RH,33,11,22,16
L3  5RL,L3,5RL,284,118,166,8
L3  5RP,L3,5RP,21,11,10,10
L3  5RY,L3,5RY,9,7,2,4
L3  5SD,L3,5SD,47,15,32,4
L3  5SL,L3,5SL,4,3,1,2
L3  5TB,L3,5TB,99,41,58,33
L3  5TL,L3,5TL,2,1,1,2
L3  5TN,L3,5TN,50,15,35,21
L3  5TQ,L3,5TQ,5,0,5,0
L3  5TS,L3,5TS,13,6,7,6
L3  5TT,L3,5TT,4,2,2,2
L3  5UB,L3,5UB,10,6,4,7
L3  5UF,L3,5UF,8,6,2,5
L3  5XA,L3,5XA,419,176,243,3
L3  5XX,L3,5XX,14,8,6,8
L3  5XY,L3,5XY,65,38,27,42
L3  5XZ,L3,5XZ,70,41,29,39
L3  6AA,L3,6AA,10,8,2,6
L3  6AE,L3,6AE,28,11,17,16
L3  6AG,L3,6AG,79,48,31,44
L3  6AL,L3,6AL,62,27,35,38
L3  6BR,L3,6BR,1,1,0,1
L3  6DA,L3,6DA,3,2,1,1
L3  6DB,L3,6DB,29,12,17,15
L3  6DD,L3,6DD,15,6,9,9
L3  6DE,L3,6DE,11,5,6,5
L3  6DF,L3,6DF,24,14,10,11
L3  6DG,L3,6DG,30,17,13,15
L3  6DH,L3,6DH,5,2,3,4
L3  6DL,L3,6DL,2,1,1,1
L3  6DQ,L3,6DQ,16,5,11,6
L3  6DX,L3,6DX,2,2,0,2
L3  6EH,L3,6EH,76,44,32,49
L3  6EL,L3,6EL,118,64,54,65
L3  6EN,L3,6EN,113,65,48,69
L3  6EP,L3,6EP,4,3,1,1
L3  6EQ,L3,6EQ,8,5,3,6
L3  6ES,L3,6ES,37,21,16,25
L3  6HB,L3,6HB,76,43,33,34
L3  6HE,L3,6HE,34,14,20,16
L3  6HG,L3,6HG,23,12,11,13
L3  6HQ,L3,6HQ,27,13,14,9
L3  6HU,L3,6HU,58,45,13,0
L3  6JF,L3,6JF,33,15,18,16
L3  6JJ,L3,6JJ,24,6,18,14
L3  6JL,L3,6JL,104,43,61,45
L3  6JN,L3,6JN,15,7,8,10
L3  6JP,L3,6JP,57,26,31,28
L3  6JQ,L3,6JQ,40,14,26,18
L3  6JR,L3,6JR,37,16,21,17
L3  6JS,L3,6JS,28,11,17,15
L3  6JT,L3,6JT,12,5,7,7
L3  6JW,L3,6JW,43,20,23,23
L3  6JX,L3,6JX,90,38,52,33
L3  6JY,L3,6JY,65,27,38,26
L3  6JZ,L3,6JZ,19,11,8,10
L3  6LA,L3,6LA,34,17,17,16
L3  6LB,L3,6LB,34,17,17,15
L3  6LD,L3,6LD,26,11,15,16
L3  6LE,L3,6LE,25,13,12,12
L3  6LF,L3,6LF,65,35,30,23
L3  6LH,L3,6LH,74,46,28,51
L3  6LL,L3,6LL,108,54,54,48
L3  6LN,L3,6LN,48,29,19,24
L3  6LP,L3,6LP,104,47,57,39
L3  6LQ,L3,6LQ,71,45,26,46
L3  6LR,L3,6LR,76,27,49,41
L3  6LS,L3,6LS,770,395,375,0
L3  6LT,L3,6LT,7,4,3,4
L3  6LU,L3,6LU,5,3,2,2
L3  6LW,L3,6LW,96,49,47,54
L3  6LX,L3,6LX,5,2,3,1
L3  6NB,L3,6NB,6,3,3,1
L3  6NE,L3,6NE,6,3,3,1
L3  6NF,L3,6NF,12,7,5,2
L3  7DT,L3,7DT,4,0,4,1
L3  7DY,L3,7DY,5,3,2,3
L3  7HF,L3,7HF,45,23,22,14
L3  7HS,L3,7HS,6,6,0,0
L3  8AB,L3,8AB,26,12,14,19
L3  8AD,L3,8AD,17,12,5,17
L3  8AL,L3,8AL,12,7,5,6
L3  8BA,L3,8BA,50,24,26,24
L3  8BB,L3,8BB,49,29,20,23
L3  8BT,L3,8BT,67,29,38,38
L3  8BU,L3,8BU,97,45,52,43
L3  8BY,L3,8BY,74,38,36,25
L3  8BZ,L3,8BZ,53,25,28,20
L3  8DA,L3,8DA,32,15,17,14
L3  8DB,L3,8DB,56,29,27,18
L3  8DP,L3,8DP,47,28,19,24
L3  8DR,L3,8DR,219,67,152,27
L3  8DT,L3,8DT,44,20,24,18
L3  8DU,L3,8DU,52,33,19,17
L3  8DW,L3,8DW,23,12,11,21
L3  8DY,L3,8DY,26,10,16,14
L3  8DZ,L3,8DZ,30,12,18,15
L3  8EA,L3,8EA,5,2,3,4
L3  8EB,L3,8EB,33,13,20,19
L3  8HA,L3,8HA,5,4,1,5
L3  8HJ,L3,8HJ,46,31,15,36
L3  8HR,L3,8HR,40,25,15,28
L3  8HY,L3,8HY,68,39,29,48
L3  8JA,L3,8JA,82,48,34,46
L3  8JD,L3,8JD,451,238,213,1
L3  8JG,L3,8JG,13,9,4,7
L3  8JR,L3,8JR,17,8,9,13
L3  8JX,L3,8JX,28,0,28,0
L3  8LE,L3,8LE,10,9,1,10
L3  8LX,L3,8LX,3,1,2,3
L3  8NA,L3,8NA,33,8,25,16
L3  8NP,L3,8NP,45,24,21,26
L3  8NY,L3,8NY,58,30,28,24
L3  8PH,L3,8PH,24,14,10,13
L3  8PJ,L3,8PJ,15,7,8,8
L3  8PQ,L3,8PQ,27,13,14,14
L3  8PS,L3,8PS,28,12,16,16
L3  8PT,L3,8PT,3,2,1,2
L3  8PZ,L3,8PZ,34,20,14,20
L3  8QA,L3,8QA,32,23,9,24
L3  8QE,L3,8QE,28,8,20,14
L3  8QG,L3,8QG,54,28,26,21
L3  9BA,L3,9BA,62,39,23,43
L3  9BB,L3,9BB,70,46,24,43
L3  9BD,L3,9BD,100,65,35,72
L3  9BE,L3,9BE,77,52,25,60
L3  9BW,L3,9BW,92,61,31,60
L3  9BZ,L3,9BZ,155,102,53,97
L3  9EJ,L3,9EJ,1,1,0,1
L3  9EL,L3,9EL,69,31,38,44
L3  9HT,L3,9HT,29,19,10,18
L3  9LU,L3,9LU,46,31,15,31
L3  9NA,L3,9NA,8,5,3,7
L3  9NS,L3,9NS,3,3,0,2
L3  9PA,L3,9PA,80,43,37,49
L3  9PE,L3,9PE,81,47,34,50
L3  9PH,L3,9PH,86,57,29,57
L3  9PJ,L3,9PJ,4,3,1,3
L3  9RE,L3,9RE,1,0,1,0
L3  9RY,L3,9RY,74,49,25,50
L3  9TY,L3,9TY,15,11,4,13
L3  9TZ,L3,9TZ,16,12,4,14
L3  9UA,L3,9UA,19,12,7,9
L3  9UB,L3,9UB,12,8,4,10
L30 0PA,L30,0PA,30,14,16,12
L30 0PB,L30,0PB,23,13,10,10
L30 0PD,L30,0PD,10,5,5,6
L30 0PE,L30,0PE,35,14,21,16
L30 0PF,L30,0PF,46,23,23,20
L30 0PG,L30,0PG,14,4,10,3
L30 0PH,L30,0PH,68,26,42,28
L30 0PJ,L30,0PJ,17,8,9,7
L30 0PL,L30,0PL,33,15,18,12
L30 0PN,L30,0PN,38,17,21,13
L30 0PP,L30,0PP,38,18,20,13
L30 0PQ,L30,0PQ,37,19,18,14
L30 0PR,L30,0PR,35,21,14,12
L30 0PS,L30,0PS,78,33,45,46
L30 0PT,L30,0PT,31,15,16,22
L30 0PU,L30,0PU,33,15,18,16
L30 0PW,L30,0PW,28,13,15,10
L30 0PX,L30,0PX,15,9,6,7
L30 0PY,L30,0PY,17,9,8,7
L30 0PZ,L30,0PZ,23,10,13,8
L30 0QA,L30,0QA,31,15,16,15
L30 0QB,L30,0QB,29,14,15,9
L30 0QD,L30,0QD,21,10,11,9
L30 0QE,L30,0QE,49,23,26,18
L30 0QF,L30,0QF,20,7,13,10
L30 0QG,L30,0QG,61,32,29,32
L30 0QH,L30,0QH,18,9,9,12
L30 0QJ,L30,0QJ,56,21,35,22
L30 0QL,L30,0QL,7,5,2,4
L30 0QP,L30,0QP,116,65,51,45
L30 0QQ,L30,0QQ,56,25,31,25
L30 0QR,L30,0QR,146,65,81,59
L30 0QS,L30,0QS,131,57,74,57
L30 0QY,L30,0QY,169,68,101,56
L30 0QZ,L30,0QZ,122,54,68,49
L30 0RA,L30,0RA,113,56,57,51
L30 0RB,L30,0RB,148,66,82,54
L30 0RD,L30,0RD,64,35,29,31
L30 0RE,L30,0RE,36,18,18,28
L30 0RF,L30,0RF,53,30,23,37
L30 0RL,L30,0RL,7,3,4,5
L30 1BB,L30,1BB,118,52,66,47
L30 1BD,L30,1BD,55,23,32,22
L30 1PA,L30,1PA,44,20,24,18
L30 1PB,L30,1PB,52,25,27,20
L30 1PD,L30,1PD,37,18,19,17
L30 1PF,L30,1PF,73,34,39,28
L30 1PG,L30,1PG,59,27,32,26
L30 1PH,L30,1PH,43,18,25,15
L30 1PJ,L30,1PJ,73,33,40,27
L30 1PL,L30,1PL,64,34,30,22
L30 1PN,L30,1PN,71,42,29,32
L30 1PP,L30,1PP,55,24,31,24
L30 1PQ,L30,1PQ,94,43,51,39
L30 1PR,L30,1PR,73,36,37,26
L30 1PS,L30,1PS,72,35,37,27
L30 1PT,L30,1PT,98,54,44,41
L30 1PU,L30,1PU,62,31,31,25
L30 1PW,L30,1PW,55,25,30,24
L30 1PX,L30,1PX,43,19,24,25
L30 1PY,L30,1PY,39,17,22,17
L30 1PZ,L30,1PZ,74,37,37,32
L30 1QA,L30,1QA,75,31,44,27
L30 1QE,L30,1QE,88,45,43,25
L30 1QF,L30,1QF,70,36,34,23
L30 1QH,L30,1QH,10,4,6,6
L30 1QJ,L30,1QJ,39,17,22,17
L30 1QL,L30,1QL,6,4,2,3
L30 1QN,L30,1QN,83,34,49,38
L30 1QP,L30,1QP,9,4,5,3
L30 1QQ,L30,1QQ,30,11,19,9
L30 1QR,L30,1QR,88,44,44,39
L30 1QS,L30,1QS,79,41,38,37
L30 1QT,L30,1QT,61,26,35,21
L30 1QU,L30,1QU,60,36,24,23
L30 1QW,L30,1QW,67,35,32,31
L30 1QX,L30,1QX,45,27,18,25
L30 1QY,L30,1QY,29,15,14,22
L30 1QZ,L30,1QZ,33,14,19,16
L30 1RE,L30,1RE,77,39,38,30
L30 1RF,L30,1RF,37,16,21,17
L30 1RG,L30,1RG,36,19,17,18
L30 1RH,L30,1RH,73,31,42,27
L30 1RL,L30,1RL,67,34,33,28
L30 1RN,L30,1RN,32,16,16,14
L30 1RP,L30,1RP,77,41,36,28
L30 1RQ,L30,1RQ,14,6,8,7
L30 1RR,L30,1RR,80,37,43,33
L30 1RS,L30,1RS,101,40,61,36
L30 1RT,L30,1RT,192,99,93,73
L30 1RW,L30,1RW,51,27,24,26
L30 1RY,L30,1RY,49,26,23,19
L30 1RZ,L30,1RZ,45,23,22,20
L30 1SA,L30,1SA,70,35,35,26
L30 1SB,L30,1SB,94,48,46,34
L30 1SD,L30,1SD,80,42,38,30
L30 1SE,L30,1SE,47,23,24,19
L30 1SG,L30,1SG,44,15,29,24
L30 1SH,L30,1SH,41,23,18,18
L30 1SJ,L30,1SJ,50,24,26,27
L30 1SP,L30,1SP,3,2,1,2
L30 1SQ,L30,1SQ,34,16,18,18
L30 1SR,L30,1SR,5,3,2,2
L30 1TB,L30,1TB,93,41,52,38
L30 1TD,L30,1TD,66,32,34,21
L30 1TE,L30,1TE,38,15,23,19
L30 1TF,L30,1TF,32,9,23,14
L30 1TG,L30,1TG,37,18,19,15
L30 1TH,L30,1TH,82,32,50,26
L30 1TQ,L30,1TQ,33,10,23,14
L30 2NB,L30,2NB,30,12,18,13
L30 2ND,L30,2ND,21,10,11,10
L30 2NE,L30,2NE,27,13,14,13
L30 2NF,L30,2NF,29,17,12,15
L30 2NG,L30,2NG,21,8,13,8
L30 2NH,L30,2NH,9,2,7,6
L30 2NJ,L30,2NJ,10,2,8,4
L30 2NL,L30,2NL,2,1,1,2
L30 2NN,L30,2NN,27,12,15,14
L30 2NP,L30,2NP,51,23,28,21
L30 2NQ,L30,2NQ,55,29,26,24
L30 2NS,L30,2NS,45,22,23,21
L30 2NT,L30,2NT,40,18,22,19
L30 2NU,L30,2NU,43,18,25,20
L30 2NW,L30,2NW,63,33,30,27
L30 2NX,L30,2NX,56,24,32,31
L30 2NY,L30,2NY,34,22,12,16
L30 2NZ,L30,2NZ,27,11,16,16
L30 2PA,L30,2PA,66,31,35,31
L30 2PB,L30,2PB,28,14,14,10
L30 2PD,L30,2PD,60,30,30,26
L30 2PE,L30,2PE,48,29,19,26
L30 2PF,L30,2PF,57,30,27,31
L30 2PG,L30,2PG,84,41,43,27
L30 2PH,L30,2PH,33,14,19,14
L30 2PJ,L30,2PJ,26,11,15,16
L30 2PL,L30,2PL,43,18,25,16
L30 2PN,L30,2PN,77,34,43,31
L30 2PQ,L30,2PQ,34,20,14,14
L30 2PR,L30,2PR,12,6,6,4
L30 2PS,L30,2PS,21,11,10,11
L30 2PT,L30,2PT,25,10,15,8
L30 2PW,L30,2PW,90,48,42,33
L30 2PX,L30,2PX,6,4,2,4
L30 2PY,L30,2PY,24,10,14,11
L30 2PZ,L30,2PZ,24,13,11,11
L30 2QA,L30,2QA,7,3,4,2
L30 2QB,L30,2QB,86,37,49,32
L30 2QD,L30,2QD,22,8,14,10
L30 2QE,L30,2QE,18,8,10,10
L30 2QF,L30,2QF,24,15,9,16
L30 2QG,L30,2QG,23,9,14,14
L30 2QH,L30,2QH,49,20,29,24
L30 2QJ,L30,2QJ,51,23,28,24
L30 2QL,L30,2QL,32,16,16,16
L30 2QN,L30,2QN,72,29,43,31
L30 2QP,L30,2QP,24,12,12,8
L30 2QQ,L30,2QQ,13,5,8,8
L30 2QR,L30,2QR,62,30,32,28
L30 2QS,L30,2QS,22,7,15,13
L30 2QT,L30,2QT,23,13,10,11
L30 2QU,L30,2QU,53,24,29,23
L30 2QW,L30,2QW,64,29,35,31
L30 2QX,L30,2QX,61,25,36,21
L30 2QY,L30,2QY,37,17,20,25
L30 2QZ,L30,2QZ,42,19,23,28
L30 2RA,L30,2RA,32,11,21,14
L30 2RB,L30,2RB,61,30,31,27
L30 2RD,L30,2RD,64,32,32,24
L30 2RE,L30,2RE,50,23,27,22
L30 2RF,L30,2RF,42,17,25,21
L30 2RG,L30,2RG,170,53,117,8
L30 2RH,L30,2RH,16,8,8,4
L30 2RJ,L30,2RJ,29,16,13,12
L30 2RL,L30,2RL,70,29,41,36
L30 2RN,L30,2RN,55,29,26,20
L30 2RP,L30,2RP,78,31,47,29
L30 2RQ,L30,2RQ,45,24,21,20
L30 2RR,L30,2RR,57,25,32,18
L30 2RS,L30,2RS,33,12,21,15
L30 2RT,L30,2RT,66,28,38,29
L30 2RU,L30,2RU,41,19,22,25
L30 2RW,L30,2RW,19,9,10,8
L30 2RX,L30,2RX,26,16,10,12
L30 2RY,L30,2RY,49,21,28,28
L30 2RZ,L30,2RZ,80,28,52,24
L30 2SD,L30,2SD,30,15,15,14
L30 2SE,L30,2SE,18,10,8,8
L30 3RX,L30,3RX,49,22,27,19
L30 3RY,L30,3RY,46,21,25,23
L30 3RZ,L30,3RZ,37,17,20,17
L30 3SA,L30,3SA,101,55,46,42
L30 3SB,L30,3SB,87,36,51,35
L30 3SD,L30,3SD,26,14,12,12
L30 3SE,L30,3SE,85,43,42,29
L30 3SF,L30,3SF,67,27,40,31
L30 3SG,L30,3SG,55,26,29,23
L30 3SH,L30,3SH,47,20,27,19
L30 3SJ,L30,3SJ,31,16,15,13
L30 3SL,L30,3SL,41,11,30,20
L30 3SN,L30,3SN,56,28,28,25
L30 3SP,L30,3SP,31,16,15,11
L30 3SQ,L30,3SQ,59,30,29,24
L30 3SR,L30,3SR,32,14,18,15
L30 3SS,L30,3SS,31,18,13,12
L30 3ST,L30,3ST,52,26,26,17
L30 3SU,L30,3SU,38,21,17,14
L30 3SW,L30,3SW,26,14,12,11
L30 3SX,L30,3SX,53,26,27,20
L30 3SY,L30,3SY,39,18,21,19
L30 3TA,L30,3TA,37,18,19,20
L30 3TB,L30,3TB,95,46,49,33
L30 3TD,L30,3TD,62,26,36,31
L30 3TE,L30,3TE,59,28,31,35
L30 3TF,L30,3TF,30,14,16,16
L30 3TG,L30,3TG,84,40,44,40
L30 3TH,L30,3TH,23,10,13,14
L30 3TJ,L30,3TJ,60,24,36,26
L30 3TN,L30,3TN,81,36,45,49
L30 3TP,L30,3TP,39,19,20,18
L30 3TR,L30,3TR,56,28,28,28
L30 3TS,L30,3TS,36,20,16,23
L30 3TT,L30,3TT,10,5,5,2
L30 3TU,L30,3TU,33,18,15,15
L30 3TW,L30,3TW,47,23,24,17
L30 3TX,L30,3TX,106,50,56,40
L30 3TY,L30,3TY,82,30,52,35
L30 3TZ,L30,3TZ,43,21,22,19
L30 3UA,L30,3UA,81,41,40,32
L30 3UB,L30,3UB,8,4,4,5
L30 4XL,L30,4XL,28,10,18,10
L30 5QD,L30,5QD,62,22,40,27
L30 5QE,L30,5QE,46,20,26,25
L30 5QF,L30,5QF,41,18,23,23
L30 5QG,L30,5QG,88,45,43,34
L30 5QH,L30,5QH,17,7,10,7
L30 5QJ,L30,5QJ,44,21,23,23
L30 5QL,L30,5QL,63,31,32,25
L30 5QP,L30,5QP,78,38,40,24
L30 5QQ,L30,5QQ,45,22,23,24
L30 5QR,L30,5QR,118,52,66,46
L30 5QS,L30,5QS,97,46,51,39
L30 5QT,L30,5QT,112,47,65,39
L30 5QU,L30,5QU,87,36,51,37
L30 5QW,L30,5QW,64,27,37,28
L30 5QX,L30,5QX,93,43,50,32
L30 5QY,L30,5QY,74,39,35,52
L30 5QZ,L30,5QZ,70,33,37,29
L30 5RA,L30,5RA,67,29,38,35
L30 5RB,L30,5RB,60,25,35,31
L30 5RD,L30,5RD,87,35,52,34
L30 5RE,L30,5RE,59,24,35,28
L30 5RF,L30,5RF,79,37,42,33
L30 5RG,L30,5RG,90,45,45,31
L30 5RJ,L30,5RJ,31,11,20,20
L30 5RL,L30,5RL,70,30,40,31
L30 5RP,L30,5RP,16,8,8,8
L30 5RQ,L30,5RQ,66,36,30,31
L30 5RR,L30,5RR,91,45,46,44
L30 5RS,L30,5RS,6,3,3,4
L30 5RT,L30,5RT,6,4,2,2
L30 5RU,L30,5RU,53,23,30,25
L30 5RW,L30,5RW,46,24,22,20
L30 5RX,L30,5RX,59,29,30,28
L30 5RY,L30,5RY,56,19,37,34
L30 5RZ,L30,5RZ,27,14,13,17
L30 5SA,L30,5SA,16,12,4,9
L30 5SB,L30,5SB,100,47,53,39
L30 5SD,L30,5SD,44,19,25,19
L30 5SE,L30,5SE,3,2,1,2
L30 5SF,L30,5SF,46,21,25,20
L30 5SG,L30,5SG,61,31,30,34
L30 5SH,L30,5SH,89,36,53,34
L30 5SJ,L30,5SJ,62,26,36,23
L30 5SL,L30,5SL,119,59,60,42
L30 5SN,L30,5SN,61,23,38,26
L30 5SQ,L30,5SQ,65,34,31,24
L30 5SR,L30,5SR,14,4,10,12
L30 5SS,L30,5SS,20,4,16,17
L30 5TB,L30,5TB,38,18,20,14
L30 6YB,L30,6YB,47,23,24,15
L30 6YD,L30,6YD,41,23,18,13
L30 6YE,L30,6YE,92,49,43,33
L30 6YF,L30,6YF,74,37,37,32
L30 6YG,L30,6YG,145,72,73,51
L30 7PA,L30,7PA,70,30,40,28
L30 7PD,L30,7PD,24,11,13,6
L30 7PE,L30,7PE,1,1,0,1
L30 7PF,L30,7PF,16,8,8,5
L30 7PH,L30,7PH,114,56,58,45
L30 7PJ,L30,7PJ,141,68,73,55
L30 7PL,L30,7PL,136,64,72,57
L30 7PN,L30,7PN,169,85,84,71
L30 7PP,L30,7PP,59,28,31,43
L30 7PQ,L30,7PQ,2,1,1,1
L30 7PT,L30,7PT,8,2,6,3
L30 7PU,L30,7PU,77,28,49,58
L30 7PW,L30,7PW,52,26,26,18
L30 7PX,L30,7PX,101,48,53,44
L30 7PY,L30,7PY,110,50,60,51
L30 7PZ,L30,7PZ,69,34,35,38
L30 7QA,L30,7QA,89,44,45,36
L30 7QB,L30,7QB,75,34,41,31
L30 7QD,L30,7QD,24,12,12,11
L30 7QE,L30,7QE,20,11,9,8
L30 7QF,L30,7QF,33,15,18,13
L30 7QG,L30,7QG,31,18,13,16
L30 7QH,L30,7QH,47,26,21,22
L30 7QJ,L30,7QJ,38,18,20,17
L30 7QL,L30,7QL,22,10,12,12
L30 7QN,L30,7QN,34,18,16,12
L30 7QP,L30,7QP,78,33,45,35
L30 7QQ,L30,7QQ,43,22,21,18
L30 7QR,L30,7QR,44,19,25,20
L30 7QS,L30,7QS,4,1,3,3
L30 7QT,L30,7QT,5,2,3,3
L30 7QU,L30,7QU,6,4,2,2
L30 7QW,L30,7QW,28,14,14,12
L30 7QX,L30,7QX,34,14,20,12
L30 7QY,L30,7QY,36,15,21,17
L30 7QZ,L30,7QZ,59,28,31,22
L30 7RA,L30,7RA,39,22,17,16
L30 7RE,L30,7RE,35,13,22,12
L30 7RF,L30,7RF,52,25,27,18
L30 7RG,L30,7RG,152,75,77,49
L30 7RH,L30,7RH,21,11,10,7
L30 7RJ,L30,7RJ,39,18,21,13
L30 7RL,L30,7RL,98,50,48,34
L30 7RN,L30,7RN,67,36,31,25
L30 7RQ,L30,7RQ,50,25,25,16
L30 7RS,L30,7RS,123,52,71,51
L30 7RT,L30,7RT,27,11,16,10
L30 7RU,L30,7RU,53,25,28,22
L30 7RW,L30,7RW,14,6,8,4
L30 7RX,L30,7RX,27,15,12,11
L30 8RA,L30,8RA,36,16,20,12
L30 8RB,L30,8RB,49,20,29,20
L30 8RD,L30,8RD,48,25,23,20
L30 8RE,L30,8RE,36,15,21,16
L30 8RF,L30,8RF,140,67,73,52
L30 8RG,L30,8RG,66,27,39,25
L30 8RH,L30,8RH,43,20,23,16
L30 8RJ,L30,8RJ,35,18,17,14
L30 8RL,L30,8RL,10,5,5,4
L30 8RN,L30,8RN,62,28,34,31
L30 8RP,L30,8RP,58,29,29,31
L30 8RQ,L30,8RQ,59,25,34,21
L30 8RR,L30,8RR,73,34,39,30
L30 8RS,L30,8RS,47,26,21,14
L30 8RT,L30,8RT,64,25,39,26
L30 8RU,L30,8RU,13,6,7,4
L30 8RW,L30,8RW,35,21,14,14
L30 8RX,L30,8RX,92,44,48,36
L30 8RY,L30,8RY,99,45,54,36
L30 8RZ,L30,8RZ,58,28,30,25
L30 8SA,L30,8SA,58,28,30,22
L30 8SB,L30,8SB,46,21,25,20
L30 8SD,L30,8SD,69,39,30,25
L30 8SE,L30,8SE,113,59,54,43
L30 9SA,L30,9SA,75,35,40,32
L30 9SB,L30,9SB,53,28,25,29
L30 9SD,L30,9SD,42,18,24,35
L30 9SE,L30,9SE,27,11,16,10
L30 9SF,L30,9SF,20,11,9,7
L30 9SG,L30,9SG,71,37,34,31
L30 9SH,L30,9SH,94,45,49,32
L30 9SJ,L30,9SJ,14,9,5,12
L30 9SL,L30,9SL,14,8,6,12
L30 9SP,L30,9SP,40,18,22,11
L30 9SQ,L30,9SQ,62,28,34,31
L30 9SR,L30,9SR,72,36,36,25
L30 9SS,L30,9SS,51,25,26,17
L30 9ST,L30,9ST,47,24,23,20
L30 9SU,L30,9SU,98,45,53,42
L30 9SX,L30,9SX,58,27,31,28
L30 9SY,L30,9SY,37,25,12,31
L30 9SZ,L30,9SZ,38,23,15,32
L30 9TB,L30,9TB,61,28,33,34
L30 9TD,L30,9TD,20,8,12,12
L30 9TE,L30,9TE,9,6,3,6
L30 9TF,L30,9TF,9,8,1,8
L31 0AH,L31,0AH,48,23,25,20
L31 0AJ,L31,0AJ,80,38,42,44
L31 0AL,L31,0AL,74,38,36,27
L31 0AN,L31,0AN,43,26,17,15
L31 0AP,L31,0AP,25,14,11,12
L31 0AQ,L31,0AQ,11,7,4,9
L31 0AR,L31,0AR,27,12,15,13
L31 0AS,L31,0AS,51,22,29,28
L31 0AT,L31,0AT,47,24,23,20
L31 0AU,L31,0AU,79,39,40,30
L31 0AW,L31,0AW,35,18,17,13
L31 0AX,L31,0AX,69,30,39,26
L31 0AY,L31,0AY,67,34,33,25
L31 0AZ,L31,0AZ,50,27,23,24
L31 0BA,L31,0BA,50,27,23,18
L31 0BB,L31,0BB,50,26,24,18
L31 0BD,L31,0BD,37,19,18,14
L31 0BE,L31,0BE,45,19,26,23
L31 0BG,L31,0BG,101,50,51,39
L31 0BH,L31,0BH,74,38,36,28
L31 0BJ,L31,0BJ,20,9,11,8
L31 0BL,L31,0BL,12,6,6,5
L31 0BN,L31,0BN,32,18,14,13
L31 0BP,L31,0BP,10,6,4,4
L31 0BQ,L31,0BQ,77,38,39,32
L31 0BR,L31,0BR,79,40,39,28
L31 0BS,L31,0BS,17,8,9,6
L31 0BT,L31,0BT,34,14,20,18
L31 0BU,L31,0BU,88,42,46,36
L31 0BW,L31,0BW,42,23,19,16
L31 0BX,L31,0BX,64,29,35,26
L31 0BY,L31,0BY,16,5,11,8
L31 0BZ,L31,0BZ,49,22,27,20
L31 0DA,L31,0DA,70,30,40,28
L31 0DB,L31,0DB,61,26,35,26
L31 0DD,L31,0DD,35,16,19,13
L31 0DE,L31,0DE,79,36,43,35
L31 0DF,L31,0DF,57,34,23,22
L31 0DG,L31,0DG,62,31,31,26
L31 0DQ,L31,0DQ,19,11,8,11
L31 0EB,L31,0EB,47,12,35,39
L31 1AD,L31,1AD,7,2,5,3
L31 1AE,L31,1AE,6,3,3,3
L31 1AF,L31,1AF,2,1,1,2
L31 1AG,L31,1AG,12,7,5,7
L31 1AH,L31,1AH,4,2,2,2
L31 1AJ,L31,1AJ,7,5,2,3
L31 1AL,L31,1AL,2,1,1,1
L31 1AN,L31,1AN,12,6,6,4
L31 1AP,L31,1AP,8,3,5,4
L31 1AQ,L31,1AQ,1,1,0,1
L31 1AR,L31,1AR,31,15,16,16
L31 1AT,L31,1AT,5,3,2,1
L31 1AU,L31,1AU,15,8,7,6
L31 1AW,L31,1AW,13,6,7,6
L31 1AX,L31,1AX,29,11,18,13
L31 1AY,L31,1AY,49,23,26,22
L31 1AZ,L31,1AZ,1,1,0,1
L31 1BA,L31,1BA,22,11,11,7
L31 1BE,L31,1BE,1,1,0,1
L31 1BG,L31,1BG,10,5,5,4
L31 1BH,L31,1BH,56,26,30,28
L31 1BJ,L31,1BJ,34,14,20,22
L31 1BL,L31,1BL,50,22,28,26
L31 1BN,L31,1BN,61,26,35,29
L31 1BP,L31,1BP,23,10,13,10
L31 1BQ,L31,1BQ,54,25,29,24
L31 1BR,L31,1BR,45,26,19,19
L31 1BS,L31,1BS,17,9,8,8
L31 1BT,L31,1BT,83,41,42,34
L31 1BU,L31,1BU,19,8,11,10
L31 1BW,L31,1BW,47,27,20,24
L31 1BX,L31,1BX,59,31,28,26
L31 1BY,L31,1BY,80,39,41,29
L31 1BZ,L31,1BZ,80,37,43,34
L31 1DA,L31,1DA,45,21,24,23
L31 1DB,L31,1DB,22,9,13,10
L31 1DD,L31,1DD,28,14,14,11
L31 1DE,L31,1DE,80,43,37,26
L31 1DG,L31,1DG,36,19,17,13
L31 1DH,L31,1DH,44,19,25,11
L31 1DJ,L31,1DJ,29,14,15,10
L31 1DL,L31,1DL,23,9,14,12
L31 1DN,L31,1DN,43,22,21,18
L31 1DP,L31,1DP,29,15,14,11
L31 1DR,L31,1DR,4,2,2,2
L31 1DT,L31,1DT,4,2,2,2
L31 1DU,L31,1DU,9,3,6,5
L31 1DW,L31,1DW,63,31,32,23
L31 1DY,L31,1DY,78,40,38,30
L31 1DZ,L31,1DZ,35,17,18,16
L31 1EA,L31,1EA,3,2,1,1
L31 1EB,L31,1EB,80,43,37,28
L31 1ED,L31,1ED,11,4,7,7
L31 1EE,L31,1EE,43,20,23,13
L31 1EF,L31,1EF,6,1,5,3
L31 1EG,L31,1EG,5,1,4,3
L31 1EH,L31,1EH,17,7,10,9
L31 1EJ,L31,1EJ,21,11,10,12
L31 1EL,L31,1EL,2,1,1,1
L31 1EN,L31,1EN,30,17,13,13
L31 1EP,L31,1EP,28,13,15,11
L31 1EQ,L31,1EQ,7,2,5,2
L31 1ES,L31,1ES,26,14,12,11
L31 1ET,L31,1ET,18,8,10,8
L31 1EU,L31,1EU,8,4,4,3
L31 1EW,L31,1EW,33,16,17,16
L31 1EX,L31,1EX,18,10,8,9
L31 1EY,L31,1EY,2,1,1,1
L31 1EZ,L31,1EZ,4,2,2,2
L31 1FB,L31,1FB,39,21,18,13
L31 1FD,L31,1FD,12,7,5,8
L31 1FE,L31,1FE,9,4,5,4
L31 1GA,L31,1GA,89,50,39,40
L31 1GB,L31,1GB,37,17,20,11
L31 1HA,L31,1HA,41,19,22,17
L31 1HB,L31,1HB,6,3,3,1
L31 1HD,L31,1HD,52,26,26,20
L31 1HE,L31,1HE,60,27,33,23
L31 1HF,L31,1HF,1,0,1,1
L31 1HG,L31,1HG,4,3,1,3
L31 1HH,L31,1HH,3,2,1,3
L31 1HN,L31,1HN,12,5,7,4
L31 1HP,L31,1HP,125,55,70,52
L31 1HW,L31,1HW,118,118,0,0
L31 1HX,L31,1HX,343,343,0,0
L31 1HZ,L31,1HZ,18,9,9,7
L31 1JB,L31,1JB,23,11,12,7
L31 1JD,L31,1JD,95,44,51,34
L31 1JF,L31,1JF,54,23,31,19
L31 1JH,L31,1JH,30,14,16,10
L31 1JN,L31,1JN,62,32,30,21
L31 1JP,L31,1JP,20,13,7,7
L31 1JQ,L31,1JQ,13,8,5,5
L31 1JR,L31,1JR,49,23,26,18
L31 1JS,L31,1JS,70,34,36,23
L31 1JU,L31,1JU,49,22,27,18
L31 1JW,L31,1JW,68,37,31,26
L31 1JX,L31,1JX,129,64,65,39
L31 1JY,L31,1JY,49,23,26,21
L31 1JZ,L31,1JZ,92,45,47,34
L31 1LA,L31,1LA,37,21,16,12
L31 1LB,L31,1LB,41,16,25,16
L31 1LD,L31,1LD,2,1,1,1
L31 1LE,L31,1LE,25,13,12,9
L31 1LF,L31,1LF,32,21,11,10
L31 1LH,L31,1LH,38,18,20,11
L31 1LJ,L31,1LJ,84,45,39,24
L31 1LL,L31,1LL,172,73,99,54
L31 1LR,L31,1LR,106,46,60,35
L31 2HD,L31,2HD,36,20,16,25
L31 2HG,L31,2HG,84,46,38,28
L31 2HH,L31,2HH,43,25,18,17
L31 2HJ,L31,2HJ,13,8,5,4
L31 2HL,L31,2HL,18,8,10,6
L31 2HN,L31,2HN,49,24,25,22
L31 2HP,L31,2HP,11,6,5,7
L31 2HQ,L31,2HQ,52,27,25,19
L31 2HS,L31,2HS,59,27,32,23
L31 2HT,L31,2HT,16,5,11,8
L31 2HU,L31,2HU,62,25,37,32
L31 2HW,L31,2HW,19,10,9,9
L31 2HX,L31,2HX,88,40,48,36
L31 2HY,L31,2HY,3,2,1,1
L31 2HZ,L31,2HZ,40,15,25,18
L31 2JA,L31,2JA,7,1,6,6
L31 2JB,L31,2JB,57,27,30,20
L31 2JD,L31,2JD,16,7,9,6
L31 2JE,L31,2JE,60,33,27,26
L31 2JF,L31,2JF,32,14,18,16
L31 2JG,L31,2JG,47,24,23,19
L31 2JJ,L31,2JJ,38,20,18,16
L31 2JL,L31,2JL,49,25,24,18
L31 2JN,L31,2JN,5,2,3,4
L31 2JP,L31,2JP,25,12,13,10
L31 2JQ,L31,2JQ,77,32,45,31
L31 2JR,L31,2JR,41,22,19,20
L31 2JS,L31,2JS,62,28,34,26
L31 2JT,L31,2JT,75,30,45,44
L31 2JU,L31,2JU,36,16,20,12
L31 2JW,L31,2JW,44,23,21,14
L31 2JX,L31,2JX,31,14,17,12
L31 2JY,L31,2JY,24,13,11,10
L31 2JZ,L31,2JZ,2,1,1,2
L31 2LA,L31,2LA,23,9,14,12
L31 2LB,L31,2LB,19,8,11,9
L31 2LD,L31,2LD,10,4,6,4
L31 2LE,L31,2LE,53,25,28,19
L31 2LF,L31,2LF,91,40,51,33
L31 2LG,L31,2LG,57,29,28,21
L31 2LH,L31,2LH,67,30,37,25
L31 2LJ,L31,2LJ,89,39,50,43
L31 2LL,L31,2LL,71,28,43,39
L31 2LN,L31,2LN,34,15,19,14
L31 2LP,L31,2LP,19,7,12,12
L31 2LQ,L31,2LQ,69,33,36,26
L31 2LR,L31,2LR,40,17,23,28
L31 2LS,L31,2LS,6,4,2,3
L31 2LT,L31,2LT,40,17,23,21
L31 2LU,L31,2LU,22,12,10,10
L31 2LW,L31,2LW,45,21,24,21
L31 2LX,L31,2LX,27,12,15,12
L31 2LY,L31,2LY,31,15,16,13
L31 2LZ,L31,2LZ,39,21,18,19
L31 2NA,L31,2NA,35,12,23,21
L31 2NB,L31,2NB,43,13,30,26
L31 2ND,L31,2ND,70,30,40,34
L31 2NE,L31,2NE,66,30,36,25
L31 2NF,L31,2NF,44,22,22,17
L31 2NG,L31,2NG,40,20,20,16
L31 2NH,L31,2NH,67,32,35,26
L31 2NJ,L31,2NJ,75,42,33,33
L31 2NL,L31,2NL,5,3,2,3
L31 2NN,L31,2NN,70,33,37,32
L31 2NP,L31,2NP,15,6,9,8
L31 2NQ,L31,2NQ,48,19,29,23
L31 2NR,L31,2NR,47,22,25,24
L31 2NS,L31,2NS,54,29,25,20
L31 2NT,L31,2NT,17,8,9,8
L31 2NU,L31,2NU,27,14,13,10
L31 2NW,L31,2NW,64,30,34,26
L31 2NX,L31,2NX,25,13,12,13
L31 2NY,L31,2NY,17,8,9,5
L31 2PB,L31,2PB,12,3,9,9
L31 2PE,L31,2PE,37,18,19,16
L31 2PG,L31,2PG,6,4,2,4
L31 2PH,L31,2PH,42,13,29,31
L31 2PJ,L31,2PJ,12,6,6,6
L31 2PL,L31,2PL,52,13,39,44
L31 2PQ,L31,2PQ,12,7,5,7
L31 2PR,L31,2PR,67,28,39,34
L31 2PS,L31,2PS,80,38,42,41
L31 2PT,L31,2PT,89,43,46,53
L31 3DA,L31,3DA,23,11,12,8
L31 3DB,L31,3DB,13,5,8,5
L31 3DD,L31,3DD,26,11,15,11
L31 3DF,L31,3DF,12,7,5,6
L31 3DG,L31,3DG,76,33,43,25
L31 3DH,L31,3DH,16,8,8,9
L31 3DL,L31,3DL,108,48,60,40
L31 3DN,L31,3DN,50,26,24,27
L31 3DP,L31,3DP,71,38,33,25
L31 3DQ,L31,3DQ,28,13,15,14
L31 3DR,L31,3DR,20,5,15,10
L31 3DS,L31,3DS,3,2,1,1
L31 3DU,L31,3DU,30,15,15,17
L31 3DW,L31,3DW,63,37,26,22
L31 3DX,L31,3DX,69,34,35,29
L31 3DY,L31,3DY,59,28,31,24
L31 3DZ,L31,3DZ,7,2,5,2
L31 3EA,L31,3EA,35,18,17,15
L31 3EB,L31,3EB,42,24,18,16
L31 3ED,L31,3ED,24,9,15,9
L31 3EF,L31,3EF,36,19,17,14
L31 3EG,L31,3EG,63,27,36,21
L31 3EH,L31,3EH,20,8,12,7
L31 3EJ,L31,3EJ,45,24,21,17
L31 3EL,L31,3EL,12,5,7,8
L31 3EN,L31,3EN,32,14,18,10
L31 3EP,L31,3EP,16,6,10,4
L31 3EQ,L31,3EQ,15,8,7,7
L31 3ER,L31,3ER,31,17,14,12
L31 3ES,L31,3ES,24,10,14,12
L31 3ET,L31,3ET,26,13,13,11
L31 3EU,L31,3EU,62,27,35,29
L31 3EW,L31,3EW,38,18,20,16
L31 3EX,L31,3EX,28,12,16,15
L31 3EY,L31,3EY,15,11,4,8
L31 3EZ,L31,3EZ,17,7,10,7
L31 3HA,L31,3HA,34,16,18,10
L31 3HB,L31,3HB,45,23,22,16
L31 3HD,L31,3HD,34,14,20,15
L31 3HE,L31,3HE,23,9,14,16
L31 3HF,L31,3HF,20,9,11,12
L31 3HG,L31,3HG,6,3,3,3
L31 3HH,L31,3HH,9,3,6,5
L31 3HN,L31,3HN,23,11,12,7
L31 3HP,L31,3HP,31,10,21,25
L31 3HR,L31,3HR,48,16,32,43
L31 3HS,L31,3HS,9,4,5,4
L31 3HT,L31,3HT,4,2,2,2
L31 3HU,L31,3HU,49,22,27,37
L31 3JD,L31,3JD,26,13,13,21
L31 4AA,L31,4AA,31,19,12,11
L31 4AB,L31,4AB,29,11,18,11
L31 4AD,L31,4AD,19,10,9,8
L31 4AE,L31,4AE,8,3,5,2
L31 4DB,L31,4DB,82,42,40,29
L31 4DD,L31,4DD,9,4,5,4
L31 4DE,L31,4DE,4,2,2,1
L31 4DF,L31,4DF,5,3,2,2
L31 4DG,L31,4DG,4,2,2,2
L31 4DH,L31,4DH,43,22,21,12
L31 4DJ,L31,4DJ,2,1,1,1
L31 4DL,L31,4DL,23,13,10,8
L31 4DN,L31,4DN,10,4,6,3
L31 4DP,L31,4DP,10,5,5,3
L31 4DQ,L31,4DQ,66,34,32,24
L31 4DR,L31,4DR,39,17,22,22
L31 4DS,L31,4DS,41,15,26,26
L31 4DT,L31,4DT,43,22,21,19
L31 4DU,L31,4DU,60,31,29,24
L31 4DW,L31,4DW,35,15,20,14
L31 4DX,L31,4DX,12,4,8,7
L31 4DY,L31,4DY,5,2,3,3
L31 4DZ,L31,4DZ,48,24,24,24
L31 4EA,L31,4EA,31,16,15,14
L31 4EB,L31,4EB,4,1,3,3
L31 4ED,L31,4ED,102,47,55,44
L31 4EE,L31,4EE,3,2,1,2
L31 4EF,L31,4EF,25,12,13,9
L31 4EG,L31,4EG,51,25,26,17
L31 4EH,L31,4EH,19,10,9,8
L31 4EJ,L31,4EJ,5,3,2,2
L31 4EL,L31,4EL,10,6,4,7
L31 4EN,L31,4EN,1,0,1,1
L31 4EP,L31,4EP,15,7,8,6
L31 4EQ,L31,4EQ,51,17,34,8
L31 4ER,L31,4ER,15,7,8,7
L31 4ES,L31,4ES,9,4,5,6
L31 4ET,L31,4ET,5,2,3,2
L31 4EU,L31,4EU,5,3,2,3
L31 4EW,L31,4EW,6,4,2,2
L31 4EX,L31,4EX,4,3,1,1
L31 4EY,L31,4EY,31,10,21,10
L31 4HA,L31,4HA,10,7,3,3
L31 4HB,L31,4HB,14,6,8,5
L31 4HD,L31,4HD,17,9,8,6
L31 4HE,L31,4HE,17,8,9,6
L31 4HF,L31,4HF,33,15,18,16
L31 4HG,L31,4HG,9,4,5,3
L31 4HH,L31,4HH,13,7,6,5
L31 4HJ,L31,4HJ,4,2,2,2
L31 4HL,L31,4HL,21,9,12,9
L31 4HN,L31,4HN,22,8,14,8
L31 4HP,L31,4HP,9,6,3,3
L31 4HQ,L31,4HQ,7,3,4,4
L31 4HR,L31,4HR,15,5,10,5
L31 4HT,L31,4HT,12,8,4,4
L31 4HU,L31,4HU,13,8,5,6
L31 4HW,L31,4HW,2,1,1,1
L31 4HX,L31,4HX,11,4,7,4
L31 4HY,L31,4HY,14,8,6,6
L31 4HZ,L31,4HZ,9,4,5,3
L31 4JA,L31,4JA,3,2,1,2
L31 4JB,L31,4JB,2,1,1,1
L31 4JD,L31,4JD,7,5,2,3
L31 4JE,L31,4JE,19,8,11,7
L31 4JF,L31,4JF,10,4,6,5
L31 4JG,L31,4JG,73,36,37,29
L31 4JH,L31,4JH,66,38,28,23
L31 4JJ,L31,4JJ,96,41,55,35
L31 4JL,L31,4JL,95,50,45,34
L31 4JN,L31,4JN,31,15,16,10
L31 4JP,L31,4JP,38,17,21,20
L31 4JQ,L31,4JQ,62,33,29,19
L31 4JR,L31,4JR,166,76,90,55
L31 4JS,L31,4JS,48,20,28,22
L31 4JT,L31,4JT,89,44,45,33
L31 4JU,L31,4JU,48,22,26,25
L31 4JW,L31,4JW,103,52,51,44
L31 4JX,L31,4JX,31,16,15,13
L31 4JY,L31,4JY,31,17,14,11
L31 4JZ,L31,4JZ,70,33,37,31
L31 4LA,L31,4LA,61,29,32,21
L31 4LB,L31,4LB,92,45,47,34
L31 4LD,L31,4LD,60,28,32,20
L31 4LF,L31,4LF,12,6,6,5
L31 4LS,L31,4LS,12,8,4,3
L31 4LT,L31,4LT,6,3,3,3
L31 5JB,L31,5JB,20,12,8,12
L31 5JE,L31,5JE,63,31,32,25
L31 5JF,L31,5JF,14,7,7,6
L31 5JG,L31,5JG,102,46,56,37
L31 5JH,L31,5JH,71,32,39,25
L31 5JJ,L31,5JJ,49,23,26,21
L31 5JL,L31,5JL,123,63,60,39
L31 5JN,L31,5JN,79,31,48,27
L31 5JP,L31,5JP,35,17,18,13
L31 5JQ,L31,5JQ,67,34,33,22
L31 5JR,L31,5JR,38,21,17,14
L31 5JS,L31,5JS,32,16,16,14
L31 5JT,L31,5JT,47,26,21,14
L31 5JU,L31,5JU,59,33,26,22
L31 5JW,L31,5JW,49,29,20,17
L31 5JX,L31,5JX,81,39,42,30
L31 5JY,L31,5JY,80,40,40,34
L31 5JZ,L31,5JZ,58,33,25,22
L31 5LA,L31,5LA,87,44,43,30
L31 5LB,L31,5LB,76,38,38,30
L31 5LD,L31,5LD,98,47,51,39
L31 5LF,L31,5LF,64,22,42,30
L31 5LG,L31,5LG,32,16,16,13
L31 5LJ,L31,5LJ,40,15,25,18
L31 5LN,L31,5LN,112,51,61,40
L31 5LP,L31,5LP,84,40,44,31
L31 5LQ,L31,5LQ,96,47,49,38
L31 5LR,L31,5LR,38,20,18,14
L31 5LS,L31,5LS,62,30,32,21
L31 5LT,L31,5LT,72,33,39,30
L31 5LU,L31,5LU,14,5,9,6
L31 5LW,L31,5LW,91,51,40,37
L31 5LX,L31,5LX,55,23,32,30
L31 5LY,L31,5LY,18,10,8,9
L31 5LZ,L31,5LZ,30,9,21,15
L31 5NB,L31,5NB,32,13,19,16
L31 5ND,L31,5ND,21,9,12,14
L31 5NE,L31,5NE,21,8,13,6
L31 5NF,L31,5NF,108,52,56,35
L31 5NG,L31,5NG,33,15,18,20
L31 5NH,L31,5NH,66,35,31,26
L31 5NJ,L31,5NJ,17,4,13,13
L31 5NL,L31,5NL,129,62,67,44
L31 5NN,L31,5NN,94,43,51,34
L31 5NP,L31,5NP,57,21,36,23
L31 5NQ,L31,5NQ,27,11,16,14
L31 5NR,L31,5NR,99,52,47,37
L31 5NS,L31,5NS,54,25,29,18
L31 5NT,L31,5NT,7,3,4,6
L31 5NW,L31,5NW,94,44,50,33
L31 5NX,L31,5NX,66,32,34,33
L31 5NY,L31,5NY,90,46,44,34
L31 5NZ,L31,5NZ,78,42,36,27
L31 5PA,L31,5PA,90,39,51,38
L31 5PB,L31,5PB,102,49,53,42
L31 5PD,L31,5PD,38,16,22,16
L31 5PL,L31,5PL,47,26,21,22
L31 5PN,L31,5PN,71,31,40,21
L31 5PP,L31,5PP,50,24,26,16
L31 5PW,L31,5PW,45,24,21,15
L31 6AA,L31,6AA,66,28,38,29
L31 6AB,L31,6AB,27,17,10,12
L31 6AD,L31,6AD,52,24,28,23
L31 6AE,L31,6AE,36,21,15,14
L31 6AF,L31,6AF,92,43,49,38
L31 6AG,L31,6AG,75,38,37,28
L31 6AH,L31,6AH,37,17,20,18
L31 6AJ,L31,6AJ,27,16,11,14
L31 6AL,L31,6AL,71,38,33,28
L31 6AN,L31,6AN,40,17,23,18
L31 6AP,L31,6AP,28,13,15,9
L31 6AQ,L31,6AQ,22,13,9,10
L31 6AR,L31,6AR,79,36,43,34
L31 6AS,L31,6AS,48,20,28,25
L31 6AT,L31,6AT,23,12,11,11
L31 6AU,L31,6AU,18,8,10,9
L31 6AW,L31,6AW,22,12,10,8
L31 6AX,L31,6AX,106,48,58,37
L31 6AY,L31,6AY,13,5,8,5
L31 6AZ,L31,6AZ,67,33,34,30
L31 6BA,L31,6BA,12,5,7,4
L31 6BB,L31,6BB,19,8,11,8
L31 6BD,L31,6BD,34,13,21,12
L31 6BE,L31,6BE,32,16,16,17
L31 6BG,L31,6BG,15,8,7,6
L31 6BH,L31,6BH,15,9,6,8
L31 6BJ,L31,6BJ,60,26,34,31
L31 6BL,L31,6BL,66,34,32,29
L31 6BN,L31,6BN,71,31,40,32
L31 6BP,L31,6BP,25,10,15,10
L31 6BQ,L31,6BQ,52,24,28,24
L31 6BR,L31,6BR,84,43,41,37
L31 6BS,L31,6BS,114,54,60,49
L31 6BT,L31,6BT,14,8,6,4
L31 6BU,L31,6BU,53,23,30,25
L31 6BW,L31,6BW,59,30,29,24
L31 6BX,L31,6BX,88,40,48,32
L31 6BY,L31,6BY,94,42,52,40
L31 6BZ,L31,6BZ,66,29,37,43
L31 6DA,L31,6DA,34,10,24,14
L31 6DB,L31,6DB,7,3,4,3
L31 6DD,L31,6DD,4,2,2,1
L31 6DE,L31,6DE,17,7,10,8
L31 6DF,L31,6DF,90,46,44,34
L31 6DG,L31,6DG,30,13,17,12
L31 6DH,L31,6DH,62,30,32,24
L31 6DJ,L31,6DJ,69,15,54,0
L31 6DL,L31,6DL,44,18,26,20
L31 6DN,L31,6DN,65,34,31,28
L31 6DP,L31,6DP,84,51,33,34
L31 6DR,L31,6DR,47,27,20,22
L31 6DS,L31,6DS,58,28,30,25
L31 6DT,L31,6DT,45,23,22,21
L31 6DU,L31,6DU,37,16,21,17
L31 6DW,L31,6DW,81,47,34,30
L31 6DX,L31,6DX,49,26,23,19
L31 6DY,L31,6DY,52,20,32,18
L31 6DZ,L31,6DZ,41,20,21,16
L31 6EA,L31,6EA,101,46,55,49
L31 6EB,L31,6EB,2,1,1,1
L31 6ED,L31,6ED,17,6,11,13
L31 6EE,L31,6EE,52,29,23,22
L31 6EF,L31,6EF,19,7,12,8
L31 6EG,L31,6EG,13,9,4,11
L31 6EP,L31,6EP,10,5,5,4
L31 6EQ,L31,6EQ,45,14,31,30
L31 6ER,L31,6ER,48,23,25,16
L31 6EU,L31,6EU,38,25,13,24
L31 6EY,L31,6EY,32,15,17,12
L31 6FB,L31,6FB,21,8,13,12
L31 7AA,L31,7AA,135,68,67,42
L31 7AB,L31,7AB,29,15,14,10
L31 7AD,L31,7AD,16,9,7,6
L31 7AE,L31,7AE,44,20,24,17
L31 7AF,L31,7AF,45,21,24,19
L31 7AG,L31,7AG,8,5,3,4
L31 7AJ,L31,7AJ,23,12,11,8
L31 7AL,L31,7AL,27,11,16,17
L31 7AN,L31,7AN,72,35,37,25
L31 7AP,L31,7AP,49,26,23,18
L31 7AR,L31,7AR,18,10,8,8
L31 7AS,L31,7AS,23,12,11,8
L31 7AT,L31,7AT,71,34,37,24
L31 7AU,L31,7AU,48,26,22,22
L31 7AX,L31,7AX,103,52,51,36
L31 7AY,L31,7AY,74,34,40,24
L31 7AZ,L31,7AZ,70,30,40,26
L31 7BA,L31,7BA,5,2,3,2
L31 7BD,L31,7BD,33,18,15,16
L31 7BE,L31,7BE,89,39,50,34
L31 7BG,L31,7BG,60,29,31,26
L31 7BJ,L31,7BJ,107,51,56,37
L31 7BL,L31,7BL,96,47,49,43
L31 7BN,L31,7BN,65,28,37,27
L31 7BP,L31,7BP,106,54,52,44
L31 7BQ,L31,7BQ,38,16,22,14
L31 7BR,L31,7BR,99,48,51,38
L31 7BS,L31,7BS,114,58,56,37
L31 7BT,L31,7BT,81,38,43,32
L31 7BU,L31,7BU,31,14,17,13
L31 7BW,L31,7BW,75,44,31,23
L31 7BX,L31,7BX,55,26,29,20
L31 7BY,L31,7BY,71,33,38,26
L31 7BZ,L31,7BZ,64,32,32,25
L31 7DA,L31,7DA,27,14,13,14
L31 7DB,L31,7DB,8,4,4,3
L31 7DD,L31,7DD,43,19,24,20
L31 7DE,L31,7DE,57,34,23,25
L31 7DF,L31,7DF,72,39,33,33
L31 7DG,L31,7DG,36,17,19,13
L31 7DH,L31,7DH,44,22,22,23
L31 7DJ,L31,7DJ,19,6,13,11
L31 7DL,L31,7DL,53,28,25,23
L31 7DN,L31,7DN,95,49,46,43
L31 7DP,L31,7DP,94,42,52,40
L31 7DQ,L31,7DQ,86,33,53,26
L31 7DR,L31,7DR,106,56,50,41
L31 7DS,L31,7DS,35,15,20,19
L31 7DT,L31,7DT,21,12,9,16
L31 7DW,L31,7DW,43,20,23,15
L31 7EA,L31,7EA,17,8,9,6
L31 7EB,L31,7EB,19,11,8,6
L31 7ER,L31,7ER,16,6,10,12
L31 7FB,L31,7FB,15,8,7,5
L31 8AA,L31,8AA,44,21,23,16
L31 8AB,L31,8AB,5,3,2,2
L31 8AD,L31,8AD,64,27,37,24
L31 8AE,L31,8AE,120,50,70,59
L31 8AF,L31,8AF,3,1,2,2
L31 8AG,L31,8AG,50,25,25,33
L31 8AH,L31,8AH,59,24,35,25
L31 8AJ,L31,8AJ,64,30,34,23
L31 8AL,L31,8AL,59,28,31,25
L31 8AN,L31,8AN,50,23,27,16
L31 8AP,L31,8AP,74,40,34,27
L31 8AQ,L31,8AQ,75,37,38,37
L31 8AR,L31,8AR,80,42,38,26
L31 8AS,L31,8AS,84,44,40,26
L31 8AT,L31,8AT,71,35,36,24
L31 8AU,L31,8AU,77,36,41,34
L31 8AW,L31,8AW,16,8,8,7
L31 8AX,L31,8AX,39,18,21,18
L31 8AY,L31,8AY,47,26,21,17
L31 8AZ,L31,8AZ,67,34,33,28
L31 8BA,L31,8BA,48,21,27,17
L31 8BB,L31,8BB,43,21,22,16
L31 8BD,L31,8BD,98,52,46,34
L31 8BE,L31,8BE,8,3,5,2
L31 8BG,L31,8BG,1,1,0,1
L31 8BH,L31,8BH,21,7,14,8
L31 8BJ,L31,8BJ,6,3,3,3
L31 8BN,L31,8BN,2,1,1,1
L31 8BQ,L31,8BQ,7,2,5,4
L31 8BT,L31,8BT,9,3,6,3
L31 8DD,L31,8DD,40,19,21,19
L31 8DE,L31,8DE,66,33,33,31
L31 8DF,L31,8DF,17,9,8,9
L31 8DG,L31,8DG,37,18,19,14
L31 8DH,L31,8DH,7,3,4,4
L31 8DJ,L31,8DJ,17,7,10,10
L31 8DL,L31,8DL,26,13,13,12
L31 8DP,L31,8DP,88,47,41,34
L31 8DQ,L31,8DQ,20,7,13,8
L31 8DR,L31,8DR,24,10,14,8
L31 8DS,L31,8DS,18,8,10,8
L31 8DT,L31,8DT,25,12,13,15
L31 8DU,L31,8DU,49,28,21,23
L31 8DW,L31,8DW,45,24,21,20
L31 8DX,L31,8DX,79,37,42,33
L31 8DY,L31,8DY,93,43,50,39
L31 8DZ,L31,8DZ,101,54,47,35
L31 8EA,L31,8EA,21,11,10,10
L31 8EB,L31,8EB,22,10,12,9
L31 8ED,L31,8ED,24,15,9,10
L31 8EF,L31,8EF,113,58,55,43
L31 8EG,L31,8EG,97,50,47,38
L31 8EH,L31,8EH,45,24,21,18
L31 8EJ,L31,8EJ,22,11,11,9
L31 8EL,L31,8EL,16,5,11,9
L31 8EN,L31,8EN,45,22,23,15
L31 8EP,L31,8EP,37,13,24,33
L31 8EQ,L31,8EQ,88,44,44,39
L31 8ER,L31,8ER,26,11,15,25
L31 8ES,L31,8ES,14,5,9,11
L31 8EW,L31,8EW,12,7,5,5
L31 8EX,L31,8EX,39,20,19,15
L31 8EY,L31,8EY,22,9,13,12
L31 9AA,L31,9AA,61,25,36,31
L31 9AB,L31,9AB,26,12,14,16
L31 9AD,L31,9AD,80,38,42,37
L31 9AE,L31,9AE,53,20,33,25
L31 9AF,L31,9AF,76,32,44,35
L31 9AG,L31,9AG,31,14,17,19
L31 9AH,L31,9AH,26,13,13,11
L31 9AJ,L31,9AJ,19,8,11,10
L31 9AL,L31,9AL,58,31,27,23
L31 9AN,L31,9AN,21,12,9,7
L31 9AP,L31,9AP,39,19,20,23
L31 9AQ,L31,9AQ,85,35,50,41
L31 9AS,L31,9AS,21,8,13,12
L31 9AT,L31,9AT,36,22,14,16
L31 9AU,L31,9AU,6,3,3,3
L31 9AW,L31,9AW,41,16,25,15
L31 9AX,L31,9AX,85,40,45,33
L31 9AY,L31,9AY,27,13,14,14
L31 9AZ,L31,9AZ,85,37,48,30
L31 9BA,L31,9BA,35,16,19,12
L31 9BB,L31,9BB,52,26,26,27
L31 9BD,L31,9BD,25,11,14,11
L31 9BE,L31,9BE,39,17,22,12
L31 9BG,L31,9BG,95,47,48,40
L31 9BH,L31,9BH,78,32,46,35
L31 9BJ,L31,9BJ,59,30,29,22
L31 9BL,L31,9BL,75,35,40,32
L31 9BN,L31,9BN,82,37,45,34
L31 9BP,L31,9BP,37,16,21,14
L31 9BQ,L31,9BQ,71,34,37,30
L31 9BR,L31,9BR,43,22,21,14
L31 9BS,L31,9BS,74,35,39,26
L31 9BT,L31,9BT,57,26,31,26
L31 9BU,L31,9BU,77,37,40,26
L31 9BW,L31,9BW,66,30,36,28
L31 9BX,L31,9BX,37,17,20,18
L31 9BY,L31,9BY,131,65,66,53
L31 9BZ,L31,9BZ,26,13,13,10
L31 9DA,L31,9DA,73,34,39,28
L31 9DB,L31,9DB,122,54,68,52
L31 9DD,L31,9DD,5,1,4,2
L31 9DE,L31,9DE,139,65,74,58
L31 9DF,L31,9DF,69,38,31,25
L31 9DG,L31,9DG,80,37,43,32
L31 9DH,L31,9DH,66,29,37,25
L31 9DJ,L31,9DJ,55,29,26,22
L31 9DL,L31,9DL,51,25,26,21
L31 9DN,L31,9DN,65,31,34,30
L31 9DP,L31,9DP,22,8,14,8
L31 9DQ,L31,9DQ,93,46,47,44
L31 9DR,L31,9DR,89,48,41,35
L31 9DS,L31,9DS,68,36,32,27
L31 9DT,L31,9DT,16,6,10,9
L31 9DU,L31,9DU,19,10,9,10
L31 9DW,L31,9DW,45,19,26,22
L31 9DX,L31,9DX,28,14,14,17
L31 9DY,L31,9DY,24,12,12,8
L31 9DZ,L31,9DZ,73,31,42,27
L31 9PA,L31,9PA,77,35,42,24
L31 9PB,L31,9PB,12,6,6,7
L31 9PD,L31,9PD,17,10,7,8
L31 9PE,L31,9PE,58,28,30,22
L31 9PF,L31,9PF,22,12,10,10
L31 9PG,L31,9PG,22,11,11,8
L31 9PJ,L31,9PJ,102,57,45,35
L31 9PL,L31,9PL,145,63,82,57
L31 9PN,L31,9PN,93,47,46,37
L31 9PQ,L31,9PQ,45,25,20,19
L31 9PR,L31,9PR,43,20,23,16
L31 9PS,L31,9PS,80,41,39,30
L31 9PT,L31,9PT,54,29,25,20
L31 9PU,L31,9PU,81,43,38,28
L31 9PW,L31,9PW,32,18,14,12
L31 9PZ,L31,9PZ,44,15,29,38
L32 0RB,L32,0RB,48,24,24,24
L32 0RD,L32,0RD,16,11,5,11
L32 0RE,L32,0RE,9,3,6,6
L32 0RF,L32,0RF,46,21,25,23
L32 0RG,L32,0RG,68,26,42,31
L32 0RH,L32,0RH,71,30,41,32
L32 0RJ,L32,0RJ,71,34,37,34
L32 0RL,L32,0RL,7,1,6,4
L32 0RN,L32,0RN,59,30,29,24
L32 0RP,L32,0RP,64,32,32,21
L32 0RR,L32,0RR,28,15,13,18
L32 0RS,L32,0RS,59,26,33,26
L32 0RT,L32,0RT,86,37,49,37
L32 0RU,L32,0RU,67,28,39,31
L32 0RW,L32,0RW,78,31,47,37
L32 0RX,L32,0RX,61,32,29,26
L32 0RY,L32,0RY,90,46,44,39
L32 0RZ,L32,0RZ,30,15,15,15
L32 0SA,L32,0SA,56,24,32,22
L32 0SB,L32,0SB,73,39,34,32
L32 0SD,L32,0SD,42,20,22,18
L32 0SE,L32,0SE,37,18,19,17
L32 0SF,L32,0SF,104,48,56,42
L32 0SG,L32,0SG,101,49,52,43
L32 0SH,L32,0SH,50,27,23,20
L32 0SJ,L32,0SJ,54,28,26,20
L32 0SL,L32,0SL,12,4,8,6
L32 0SN,L32,0SN,24,8,16,6
L32 0SP,L32,0SP,10,5,5,4
L32 0SQ,L32,0SQ,47,20,27,16
L32 0SR,L32,0SR,9,3,6,3
L32 0SS,L32,0SS,24,13,11,9
L32 0ST,L32,0ST,22,11,11,11
L32 0SU,L32,0SU,18,7,11,7
L32 0SW,L32,0SW,49,24,25,22
L32 0SX,L32,0SX,42,17,25,14
L32 0SY,L32,0SY,69,31,38,30
L32 0SZ,L32,0SZ,60,26,34,24
L32 0TA,L32,0TA,67,33,34,27
L32 0TB,L32,0TB,69,35,34,33
L32 0TD,L32,0TD,17,8,9,8
L32 0TE,L32,0TE,21,11,10,14
L32 0TF,L32,0TF,10,4,6,5
L32 0TH,L32,0TH,69,33,36,26
L32 0TJ,L32,0TJ,23,7,16,9
L32 0TL,L32,0TL,28,13,15,13
L32 0TN,L32,0TN,9,3,6,4
L32 0TP,L32,0TP,3,2,1,2
L32 0TQ,L32,0TQ,20,9,11,10
L32 0TR,L32,0TR,16,9,7,9
L32 0TS,L32,0TS,67,27,40,23
L32 0TT,L32,0TT,46,27,19,27
L32 0TW,L32,0TW,43,14,29,18
L32 0TX,L32,0TX,61,28,33,20
L32 0TY,L32,0TY,20,8,12,10
L32 0UA,L32,0UA,55,26,29,22
L32 0UB,L32,0UB,35,11,24,16
L32 0UD,L32,0UD,54,25,29,23
L32 0UE,L32,0UE,51,22,29,19
L32 0UF,L32,0UF,47,19,28,21
L32 0UG,L32,0UG,47,20,27,18
L32 0UH,L32,0UH,37,14,23,17
L32 0UJ,L32,0UJ,29,11,18,10
L32 0UL,L32,0UL,77,39,38,34
L32 0UN,L32,0UN,39,16,23,15
L32 0UP,L32,0UP,41,20,21,19
L32 0UQ,L32,0UQ,13,8,5,6
L32 0UR,L32,0UR,19,10,9,12
L32 0US,L32,0US,9,2,7,3
L32 0UW,L32,0UW,31,17,14,12
L32 0UZ,L32,0UZ,83,33,50,34
L32 0WA,L32,0WA,39,16,23,18
L32 0XA,L32,0XA,27,13,14,12
L32 0XB,L32,0XB,67,33,34,26
L32 0XE,L32,0XE,66,26,40,22
L32 0XF,L32,0XF,31,19,12,10
L32 0XH,L32,0XH,126,50,76,66
L32 0XJ,L32,0XJ,17,8,9,5
L32 0XL,L32,0XL,28,12,16,11
L32 0XQ,L32,0XQ,9,5,4,3
L32 1BA,L32,1BA,119,59,60,40
L32 1BB,L32,1BB,84,41,43,29
L32 1BD,L32,1BD,17,8,9,6
L32 1BE,L32,1BE,44,18,26,12
L32 1BG,L32,1BG,84,38,46,25
L32 1BH,L32,1BH,58,30,28,15
L32 1BJ,L32,1BJ,31,14,17,11
L32 1BN,L32,1BN,46,21,25,13
L32 1BQ,L32,1BQ,30,18,12,11
L32 1BT,L32,1BT,70,35,35,28
L32 1BU,L32,1BU,24,13,11,13
L32 1TA,L32,1TA,33,14,19,18
L32 1TB,L32,1TB,49,17,32,21
L32 1TD,L32,1TD,15,10,5,5
L32 1TE,L32,1TE,36,15,21,14
L32 1TF,L32,1TF,57,26,31,28
L32 1TG,L32,1TG,21,11,10,8
L32 1TH,L32,1TH,49,19,30,24
L32 1TJ,L32,1TJ,80,35,45,39
L32 1TL,L32,1TL,62,29,33,25
L32 1TN,L32,1TN,60,27,33,29
L32 1TP,L32,1TP,45,23,22,22
L32 1TQ,L32,1TQ,48,21,27,23
L32 1TR,L32,1TR,69,32,37,26
L32 1TS,L32,1TS,45,23,22,16
L32 1TT,L32,1TT,81,38,43,35
L32 1TU,L32,1TU,14,8,6,5
L32 1TW,L32,1TW,89,39,50,31
L32 2AD,L32,2AD,15,9,6,8
L32 2AE,L32,2AE,9,3,6,5
L32 2AF,L32,2AF,2,1,1,2
L32 2AG,L32,2AG,68,34,34,27
L32 2AJ,L32,2AJ,52,19,33,29
L32 2AL,L32,2AL,78,42,36,36
L32 2AN,L32,2AN,68,36,32,37
L32 2AP,L32,2AP,88,45,43,38
L32 2AQ,L32,2AQ,56,34,22,27
L32 2AR,L32,2AR,66,31,35,45
L32 2AS,L32,2AS,64,32,32,30
L32 2AU,L32,2AU,29,13,16,9
L32 2AW,L32,2AW,96,50,46,43
L32 2AX,L32,2AX,18,9,9,5
L32 2AZ,L32,2AZ,116,59,57,44
L32 2BA,L32,2BA,106,56,50,45
L32 2BB,L32,2BB,96,46,50,37
L32 2BD,L32,2BD,24,15,9,20
L32 2BE,L32,2BE,59,27,32,26
L32 2BG,L32,2BG,4,2,2,1
L32 2BH,L32,2BH,61,28,33,27
L32 2BJ,L32,2BJ,61,25,36,28
L32 2BL,L32,2BL,117,55,62,47
L32 2BN,L32,2BN,75,39,36,35
L32 2BP,L32,2BP,11,5,6,4
L32 2BQ,L32,2BQ,46,21,25,19
L32 2BR,L32,2BR,36,21,15,13
L32 2BS,L32,2BS,147,70,77,59
L32 2BT,L32,2BT,64,38,26,19
L32 2BU,L32,2BU,28,10,18,21
L32 2BW,L32,2BW,64,35,29,26
L32 2BY,L32,2BY,7,4,3,4
L32 2BZ,L32,2BZ,20,9,11,9
L32 2DD,L32,2DD,46,20,26,41
L32 2DE,L32,2DE,96,43,53,37
L32 2DF,L32,2DF,8,5,3,5
L32 2DG,L32,2DG,10,5,5,5
L32 2DH,L32,2DH,45,23,22,15
L32 2DJ,L32,2DJ,93,44,49,30
L32 2DL,L32,2DL,27,15,12,7
L32 2DN,L32,2DN,69,35,34,19
L32 2DP,L32,2DP,19,10,9,12
L32 2DQ,L32,2DQ,93,50,43,29
L32 3XA,L32,3XA,75,35,40,38
L32 3XB,L32,3XB,58,29,29,22
L32 3XD,L32,3XD,35,16,19,12
L32 3XE,L32,3XE,79,33,46,42
L32 3XF,L32,3XF,59,20,39,26
L32 3XG,L32,3XG,26,10,16,8
L32 3XH,L32,3XH,69,28,41,30
L32 3XJ,L32,3XJ,60,27,33,29
L32 3XL,L32,3XL,54,25,29,22
L32 3XN,L32,3XN,40,17,23,14
L32 3XP,L32,3XP,5,2,3,4
L32 3XQ,L32,3XQ,36,19,17,16
L32 3XR,L32,3XR,12,6,6,4
L32 3XS,L32,3XS,34,16,18,14
L32 3XT,L32,3XT,57,31,26,21
L32 3XU,L32,3XU,54,21,33,19
L32 3XW,L32,3XW,43,24,19,17
L32 3XX,L32,3XX,72,34,38,32
L32 3XY,L32,3XY,68,31,37,31
L32 3XZ,L32,3XZ,78,38,40,34
L32 3YA,L32,3YA,43,19,24,16
L32 3YB,L32,3YB,16,11,5,4
L32 3YD,L32,3YD,35,14,21,16
L32 3YE,L32,3YE,17,7,10,10
L32 3YF,L32,3YF,46,19,27,19
L32 3YG,L32,3YG,49,21,28,23
L32 3YJ,L32,3YJ,18,8,10,7
L32 4RY,L32,4RY,10,3,7,7
L32 4RZ,L32,4RZ,19,10,9,10
L32 4SA,L32,4SA,6,1,5,3
L32 4SD,L32,4SD,4,2,2,2
L32 4SE,L32,4SE,11,7,4,4
L32 4SF,L32,4SF,14,7,7,5
L32 4SG,L32,4SG,29,14,15,15
L32 4SH,L32,4SH,39,22,17,20
L32 4SJ,L32,4SJ,45,23,22,19
L32 4SL,L32,4SL,1,0,1,1
L32 4SN,L32,4SN,32,18,14,16
L32 4SP,L32,4SP,34,17,17,12
L32 4SQ,L32,4SQ,58,30,28,24
L32 4SR,L32,4SR,14,8,6,6
L32 4SS,L32,4SS,8,6,2,4
L32 4ST,L32,4ST,36,15,21,14
L32 4SU,L32,4SU,26,10,16,12
L32 4SW,L32,4SW,53,24,29,21
L32 4SX,L32,4SX,47,24,23,19
L32 4SY,L32,4SY,5,3,2,5
L32 4SZ,L32,4SZ,66,23,43,25
L32 4TA,L32,4TA,46,23,23,19
L32 4TB,L32,4TB,51,26,25,17
L32 4TD,L32,4TD,24,10,14,11
L32 4TE,L32,4TE,71,31,40,33
L32 4TF,L32,4TF,30,17,13,10
L32 4TG,L32,4TG,51,26,25,20
L32 4TH,L32,4TH,48,21,27,23
L32 4TQ,L32,4TQ,59,25,34,26
L32 4TU,L32,4TU,11,7,4,5
L32 4TX,L32,4TX,22,9,13,10
L32 4TY,L32,4TY,25,11,14,13
L32 4TZ,L32,4TZ,12,5,7,6
L32 4UA,L32,4UA,38,17,21,16
L32 4UB,L32,4UB,38,19,19,13
L32 4UD,L32,4UD,25,13,12,11
L32 4UE,L32,4UE,28,14,14,12
L32 4UF,L32,4UF,21,10,11,10
L32 4UG,L32,4UG,50,27,23,21
L32 4UJ,L32,4UJ,12,3,9,5
L32 4UL,L32,4UL,42,24,18,17
L32 4UN,L32,4UN,43,19,24,24
L32 4UQ,L32,4UQ,47,16,31,20
L32 4UR,L32,4UR,51,25,26,14
L32 4US,L32,4US,39,23,16,16
L32 4UT,L32,4UT,40,23,17,17
L32 4UU,L32,4UU,57,27,30,23
L32 4UX,L32,4UX,19,7,12,13
L32 4UY,L32,4UY,27,10,17,13
L32 4WA,L32,4WA,62,27,35,21
L32 4WB,L32,4WB,24,13,11,7
L32 4XD,L32,4XD,24,15,9,8
L32 5SR,L32,5SR,11,5,6,5
L32 5SS,L32,5SS,11,4,7,5
L32 5ST,L32,5ST,28,11,17,9
L32 5SU,L32,5SU,75,34,41,27
L32 5SZ,L32,5SZ,21,8,13,11
L32 5TA,L32,5TA,42,18,24,19
L32 5TB,L32,5TB,54,27,27,25
L32 5TD,L32,5TD,59,20,39,10
L32 5TE,L32,5TE,58,19,39,23
L32 5TG,L32,5TG,56,26,30,22
L32 5TH,L32,5TH,5,3,2,2
L32 5TJ,L32,5TJ,12,8,4,5
L32 5TL,L32,5TL,84,34,50,33
L32 5TN,L32,5TN,49,23,26,20
L32 5TP,L32,5TP,4,2,2,2
L32 5TQ,L32,5TQ,13,6,7,8
L32 5TR,L32,5TR,29,11,18,14
L32 5TS,L32,5TS,15,7,8,10
L32 5TU,L32,5TU,90,46,44,37
L32 5TW,L32,5TW,35,12,23,17
L32 5TY,L32,5TY,42,17,25,19
L32 5UP,L32,5UP,37,18,19,24
L32 6QB,L32,6QB,45,17,28,17
L32 6QD,L32,6QD,16,11,5,14
L32 6QE,L32,6QE,48,15,33,19
L32 6QF,L32,6QF,19,10,9,8
L32 6QH,L32,6QH,15,8,7,5
L32 6QL,L32,6QL,18,10,8,9
L32 6QN,L32,6QN,49,18,31,20
L32 6QP,L32,6QP,26,15,11,20
L32 6QQ,L32,6QQ,27,13,14,16
L32 6QR,L32,6QR,84,34,50,38
L32 6QS,L32,6QS,34,12,22,17
L32 6QT,L32,6QT,66,37,29,35
L32 6QU,L32,6QU,34,13,21,16
L32 6QW,L32,6QW,41,17,24,16
L32 6QX,L32,6QX,38,21,17,31
L32 6QY,L32,6QY,35,15,20,33
L32 6QZ,L32,6QZ,32,25,7,31
L32 6RA,L32,6RA,31,24,7,28
L32 6RB,L32,6RB,23,17,6,21
L32 6RD,L32,6RD,44,32,12,37
L32 6RE,L32,6RE,31,22,9,27
L32 6RF,L32,6RF,36,31,5,35
L32 6RG,L32,6RG,55,21,34,26
L32 6RH,L32,6RH,64,29,35,26
L32 6RJ,L32,6RJ,50,24,26,20
L32 6RL,L32,6RL,24,12,12,8
L32 6RN,L32,6RN,71,33,38,30
L32 6RP,L32,6RP,30,14,16,14
L32 6RQ,L32,6RQ,54,27,27,26
L32 6RR,L32,6RR,52,26,26,20
L32 6RS,L32,6RS,31,16,15,17
L32 6RT,L32,6RT,70,32,38,33
L32 6RU,L32,6RU,15,6,9,6
L32 6RW,L32,6RW,42,17,25,18
L32 6RX,L32,6RX,77,36,41,26
L32 6RY,L32,6RY,50,16,34,17
L32 6SA,L32,6SA,23,13,10,8
L32 6SB,L32,6SB,28,12,16,13
L32 6SD,L32,6SD,21,10,11,7
L32 6SE,L32,6SE,56,27,29,27
L32 6SF,L32,6SF,15,7,8,8
L32 6SG,L32,6SG,63,32,31,21
L32 6SH,L32,6SH,36,18,18,17
L32 6SJ,L32,6SJ,51,27,24,19
L32 6SL,L32,6SL,39,14,25,19
L32 6SN,L32,6SN,31,21,10,19
L32 6SQ,L32,6SQ,35,18,17,20
L32 6SR,L32,6SR,10,6,4,6
L32 6SS,L32,6SS,10,4,6,3
L32 6ST,L32,6ST,16,7,9,6
L32 6SW,L32,6SW,18,8,10,8
L32 6SZ,L32,6SZ,18,9,9,15
L32 7PA,L32,7PA,3,1,2,1
L32 7PB,L32,7PB,33,19,14,15
L32 7PD,L32,7PD,71,38,33,31
L32 7PE,L32,7PE,25,12,13,13
L32 7PF,L32,7PF,47,21,26,22
L32 7PH,L32,7PH,42,18,24,18
L32 7PJ,L32,7PJ,28,11,17,11
L32 7PL,L32,7PL,43,19,24,21
L32 7PN,L32,7PN,43,18,25,19
L32 7PP,L32,7PP,67,30,37,32
L32 7PQ,L32,7PQ,63,28,35,25
L32 7PR,L32,7PR,35,19,16,15
L32 7PS,L32,7PS,20,11,9,8
L32 7PT,L32,7PT,67,33,34,29
L32 7PU,L32,7PU,7,4,3,4
L32 7PW,L32,7PW,46,23,23,24
L32 7PY,L32,7PY,5,3,2,4
L32 7PZ,L32,7PZ,29,16,13,11
L32 7QA,L32,7QA,3,2,1,2
L32 7QE,L32,7QE,40,21,19,16
L32 7QF,L32,7QF,66,33,33,26
L32 7QG,L32,7QG,58,28,30,26
L32 7QH,L32,7QH,49,9,40,30
L32 7QJ,L32,7QJ,34,17,17,15
L32 7QL,L32,7QL,39,21,18,18
L32 7QN,L32,7QN,54,23,31,23
L32 7QP,L32,7QP,29,12,17,13
L32 7QQ,L32,7QQ,50,19,31,21
L32 7QR,L32,7QR,38,20,18,16
L32 7QS,L32,7QS,60,30,30,26
L32 7QT,L32,7QT,61,23,38,22
L32 7QU,L32,7QU,34,11,23,17
L32 7QW,L32,7QW,43,20,23,17
L32 7QX,L32,7QX,48,22,26,17
L32 7QY,L32,7QY,24,16,8,10
L32 7RA,L32,7RA,36,22,14,10
L32 7RB,L32,7RB,10,6,4,3
L32 7RD,L32,7RD,7,3,4,4
L32 7RE,L32,7RE,37,17,20,11
L32 7RF,L32,7RF,12,2,10,9
L32 7RG,L32,7RG,24,13,11,8
L32 7RH,L32,7RH,51,24,27,27
L32 7RJ,L32,7RJ,30,18,12,9
L32 7RL,L32,7RL,22,9,13,9
L32 7RN,L32,7RN,93,45,48,36
L32 7RP,L32,7RP,68,38,30,25
L32 7RQ,L32,7RQ,16,6,10,7
L32 7RR,L32,7RR,35,20,15,12
L32 7RS,L32,7RS,43,22,21,12
L32 7RT,L32,7RT,19,9,10,7
L32 7RW,L32,7RW,50,22,28,23
L32 7RX,L32,7RX,53,24,29,21
L32 7RZ,L32,7RZ,1,0,1,1
L32 7SA,L32,7SA,16,10,6,9
L32 7SB,L32,7SB,4,2,2,2
L32 7SD,L32,7SD,21,10,11,5
L32 7SE,L32,7SE,29,16,13,11
L32 7SF,L32,7SF,27,10,17,12
L32 8RD,L32,8RD,1,1,0,1
L32 8SD,L32,8SD,37,19,18,20
L32 8SL,L32,8SL,77,41,36,35
L32 8SN,L32,8SN,41,24,17,28
L32 8SP,L32,8SP,44,25,19,18
L32 8SQ,L32,8SQ,46,19,27,17
L32 8SR,L32,8SR,28,12,16,13
L32 8SS,L32,8SS,57,22,35,16
L32 8ST,L32,8ST,73,38,35,28
L32 8SU,L32,8SU,58,27,31,20
L32 8SW,L32,8SW,49,31,18,45
L32 8SX,L32,8SX,76,35,41,30
L32 8SY,L32,8SY,42,22,20,15
L32 8SZ,L32,8SZ,37,19,18,11
L32 8TA,L32,8TA,36,20,16,17
L32 8TB,L32,8TB,69,29,40,33
L32 8TD,L32,8TD,45,20,25,27
L32 8TE,L32,8TE,36,18,18,16
L32 8TF,L32,8TF,14,5,9,6
L32 8TG,L32,8TG,20,8,12,14
L32 8TH,L32,8TH,35,14,21,14
L32 8TJ,L32,8TJ,18,8,10,8
L32 8TL,L32,8TL,28,11,17,10
L32 8TN,L32,8TN,51,24,27,19
L32 8TP,L32,8TP,63,28,35,22
L32 8TQ,L32,8TQ,56,23,33,19
L32 8TR,L32,8TR,81,39,42,32
L32 8TS,L32,8TS,40,12,28,18
L32 8TT,L32,8TT,84,34,50,33
L32 8TU,L32,8TU,29,13,16,12
L32 8TW,L32,8TW,50,25,25,18
L32 8TX,L32,8TX,24,7,17,13
L32 8TY,L32,8TY,77,34,43,29
L32 8TZ,L32,8TZ,58,20,38,22
L32 8UA,L32,8UA,75,33,42,26
L32 8UB,L32,8UB,16,8,8,8
L32 8UE,L32,8UE,9,4,5,3
L32 8UJ,L32,8UJ,60,23,37,26
L32 8UL,L32,8UL,56,18,38,31
L32 8UN,L32,8UN,32,16,16,12
L32 8UQ,L32,8UQ,24,8,16,10
L32 8XB,L32,8XB,31,13,18,12
L32 8XD,L32,8XD,25,8,17,10
L32 8XE,L32,8XE,68,29,39,29
L32 8XF,L32,8XF,37,15,22,11
L32 8XP,L32,8XP,23,12,11,10
L32 8YB,L32,8YB,2,0,2,2
L32 8ZP,L32,8ZP,45,17,28,19
L32 9BA,L32,9BA,147,70,77,46
L32 9BB,L32,9BB,52,20,32,15
L32 9BD,L32,9BD,25,11,14,11
L32 9PA,L32,9PA,68,34,34,26
L32 9PB,L32,9PB,45,19,26,23
L32 9PE,L32,9PE,55,26,29,21
L32 9PF,L32,9PF,27,16,11,16
L32 9PG,L32,9PG,27,15,12,12
L32 9PL,L32,9PL,41,21,20,16
L32 9PN,L32,9PN,13,5,8,9
L32 9PQ,L32,9PQ,44,28,16,19
L32 9PR,L32,9PR,30,18,12,11
L32 9PS,L32,9PS,34,13,21,18
L32 9PT,L32,9PT,24,9,15,9
L32 9PU,L32,9PU,90,51,39,47
L32 9PW,L32,9PW,47,25,22,22
L32 9PX,L32,9PX,59,30,29,19
L32 9PY,L32,9PY,85,40,45,42
L32 9PZ,L32,9PZ,45,23,22,21
L32 9QA,L32,9QA,37,16,21,18
L32 9QB,L32,9QB,14,8,6,6
L32 9QD,L32,9QD,23,10,13,12
L32 9QE,L32,9QE,49,19,30,20
L32 9QF,L32,9QF,60,25,35,26
L32 9QG,L32,9QG,47,29,18,22
L32 9QH,L32,9QH,46,21,25,21
L32 9QJ,L32,9QJ,33,17,16,13
L32 9QL,L32,9QL,44,16,28,22
L32 9QN,L32,9QN,41,19,22,16
L32 9QP,L32,9QP,50,25,25,24
L32 9QQ,L32,9QQ,27,15,12,10
L32 9QR,L32,9QR,55,25,30,18
L32 9QS,L32,9QS,44,20,24,20
L32 9QT,L32,9QT,33,17,16,15
L32 9QU,L32,9QU,91,47,44,39
L32 9QW,L32,9QW,44,16,28,21
L32 9QX,L32,9QX,65,32,33,25
L32 9QY,L32,9QY,55,30,25,21
L32 9QZ,L32,9QZ,46,16,30,15
L32 9RA,L32,9RA,18,12,6,7
L32 9RB,L32,9RB,73,31,42,27
L32 9RD,L32,9RD,55,28,27,21
L32 9RE,L32,9RE,25,12,13,10
L32 9RF,L32,9RF,35,17,18,17
L32 9RG,L32,9RG,46,24,22,20
L32 9RH,L32,9RH,64,29,35,23
L32 9RJ,L32,9RJ,53,27,26,21
L32 9RL,L32,9RL,50,23,27,19
L32 9RN,L32,9RN,46,20,26,28
L32 9RP,L32,9RP,28,13,15,16
L32 9RQ,L32,9RQ,49,19,30,21
L32 9RS,L32,9RS,42,20,22,17
L32 9RT,L32,9RT,48,22,26,16
L32 9RW,L32,9RW,72,31,41,30
L32 9RX,L32,9RX,6,2,4,3
L32 9SA,L32,9SA,13,6,7,5
L32 9SB,L32,9SB,7,2,5,5
L32 9SD,L32,9SD,35,19,16,11
L32 9SF,L32,9SF,15,6,9,8
L32 9SG,L32,9SG,84,40,44,31
L32 9SH,L32,9SH,188,93,95,59
L32 9SJ,L32,9SJ,31,14,17,9
L32 9SL,L32,9SL,46,23,23,16
L32 9SN,L32,9SN,31,16,15,11
L32 9SP,L32,9SP,10,3,7,4
L32 9SQ,L32,9SQ,76,34,42,19
L32 9SR,L32,9SR,70,40,30,28
L32 9SS,L32,9SS,88,42,46,28
L32 9ST,L32,9ST,22,11,11,6
L32 9SU,L32,9SU,22,13,9,6
L32 9SW,L32,9SW,43,19,24,21
L33 0XA,L33,0XA,43,18,25,20
L33 0XB,L33,0XB,46,24,22,30
L33 0XD,L33,0XD,47,28,19,22
L33 0XE,L33,0XE,48,23,25,27
L33 0XF,L33,0XF,5,2,3,3
L33 0XG,L33,0XG,44,21,23,17
L33 0XH,L33,0XH,103,46,57,31
L33 0XJ,L33,0XJ,26,12,14,14
L33 0XN,L33,0XN,8,6,2,6
L33 0XP,L33,0XP,41,22,19,13
L33 0XQ,L33,0XQ,17,6,11,7
L33 0XR,L33,0XR,81,31,50,31
L33 0XS,L33,0XS,23,12,11,9
L33 0XT,L33,0XT,11,7,4,5
L33 0XU,L33,0XU,27,11,16,14
L33 0XW,L33,0XW,37,13,24,18
L33 0XX,L33,0XX,29,15,14,12
L33 0XY,L33,0XY,84,43,41,34
L33 0XZ,L33,0XZ,54,25,29,23
L33 0YA,L33,0YA,46,26,20,29
L33 0YB,L33,0YB,30,17,13,15
L33 0YD,L33,0YD,56,31,25,29
L33 0YE,L33,0YE,54,28,26,20
L33 0YQ,L33,0YQ,43,23,20,15
L33 1AB,L33,1AB,53,23,30,22
L33 1AD,L33,1AD,23,10,13,10
L33 1ED,L33,1ED,120,59,61,48
L33 1EE,L33,1EE,44,21,23,18
L33 1EF,L33,1EF,55,30,25,22
L33 1EG,L33,1EG,31,13,18,12
L33 1EH,L33,1EH,86,44,42,32
L33 1EJ,L33,1EJ,66,34,32,23
L33 1EL,L33,1EL,50,26,24,20
L33 1EN,L33,1EN,31,16,15,18
L33 1EQ,L33,1EQ,67,29,38,27
L33 1ER,L33,1ER,76,39,37,30
L33 1EW,L33,1EW,37,13,24,17
L33 1QZ,L33,1QZ,24,8,16,10
L33 1RA,L33,1RA,15,3,12,6
L33 1RB,L33,1RB,11,5,6,7
L33 1RD,L33,1RD,10,2,8,4
L33 1RE,L33,1RE,21,10,11,6
L33 1RF,L33,1RF,34,16,18,16
L33 1RG,L33,1RG,46,19,27,19
L33 1RH,L33,1RH,39,14,25,17
L33 1RJ,L33,1RJ,46,17,29,19
L33 1RL,L33,1RL,30,14,16,16
L33 1RN,L33,1RN,16,7,9,6
L33 1RP,L33,1RP,24,13,11,10
L33 1RR,L33,1RR,80,34,46,29
L33 1RT,L33,1RT,29,11,18,11
L33 1RU,L33,1RU,18,10,8,6
L33 1RW,L33,1RW,57,25,32,22
L33 1RX,L33,1RX,4,1,3,3
L33 1RY,L33,1RY,9,5,4,4
L33 1RZ,L33,1RZ,22,9,13,7
L33 1SA,L33,1SA,118,53,65,41
L33 1SB,L33,1SB,66,30,36,25
L33 1SD,L33,1SD,29,12,17,14
L33 1SE,L33,1SE,6,1,5,4
L33 1SF,L33,1SF,11,5,6,6
L33 1SG,L33,1SG,25,11,14,10
L33 1SH,L33,1SH,134,63,71,53
L33 1SL,L33,1SL,10,6,4,5
L33 1SN,L33,1SN,28,16,12,9
L33 1SP,L33,1SP,14,7,7,6
L33 1SQ,L33,1SQ,82,37,45,38
L33 1SR,L33,1SR,26,10,16,11
L33 1SS,L33,1SS,38,19,19,13
L33 1ST,L33,1ST,8,4,4,5
L33 1SU,L33,1SU,39,17,22,17
L33 1SW,L33,1SW,34,18,16,12
L33 1SX,L33,1SX,17,7,10,6
L33 1SY,L33,1SY,24,9,15,10
L33 1SZ,L33,1SZ,75,28,47,27
L33 1TA,L33,1TA,94,42,52,41
L33 1TB,L33,1TB,29,14,15,12
L33 1TD,L33,1TD,60,29,31,23
L33 1TE,L33,1TE,29,13,16,13
L33 1TF,L33,1TF,26,12,14,11
L33 1TG,L33,1TG,58,29,29,21
L33 1TH,L33,1TH,21,14,7,8
L33 1TJ,L33,1TJ,35,18,17,12
L33 1TN,L33,1TN,41,24,17,15
L33 1TP,L33,1TP,56,26,30,17
L33 1TR,L33,1TR,20,11,9,7
L33 1TS,L33,1TS,21,7,14,6
L33 1TT,L33,1TT,14,6,8,5
L33 1TW,L33,1TW,53,15,38,22
L33 1TX,L33,1TX,16,7,9,5
L33 1TZ,L33,1TZ,13,7,6,5
L33 1UA,L33,1UA,20,7,13,6
L33 1UE,L33,1UE,3,1,2,1
L33 1UF,L33,1UF,20,8,12,6
L33 1UG,L33,1UG,21,8,13,7
L33 1UH,L33,1UH,10,3,7,5
L33 1UJ,L33,1UJ,36,15,21,12
L33 1UL,L33,1UL,14,5,9,6
L33 1UN,L33,1UN,50,23,27,17
L33 1UP,L33,1UP,61,28,33,19
L33 1UQ,L33,1UQ,32,15,17,13
L33 1UR,L33,1UR,21,11,10,9
L33 1US,L33,1US,47,18,29,17
L33 1UT,L33,1UT,23,11,12,8
L33 1UU,L33,1UU,77,33,44,30
L33 1UW,L33,1UW,38,19,19,16
L33 1UY,L33,1UY,47,18,29,37
L33 1WA,L33,1WA,52,25,27,22
L33 1WB,L33,1WB,29,15,14,10
L33 1WD,L33,1WD,51,21,30,16
L33 1WE,L33,1WE,33,18,15,11
L33 1WF,L33,1WF,44,18,26,19
L33 1WU,L33,1WU,16,6,10,6
L33 1WX,L33,1WX,28,18,10,10
L33 1WY,L33,1WY,50,22,28,25
L33 1WZ,L33,1WZ,66,33,33,30
L33 1XA,L33,1XA,3,3,0,2
L33 1XD,L33,1XD,1,1,0,1
L33 1YF,L33,1YF,34,18,16,14
L33 1YL,L33,1YL,55,26,29,23
L33 1YR,L33,1YR,41,16,25,17
L33 1YX,L33,1YX,14,5,9,7
L33 1ZA,L33,1ZA,62,20,42,25
L33 1ZB,L33,1ZB,56,25,31,16
L33 1ZD,L33,1ZD,55,22,33,19
L33 1ZE,L33,1ZE,50,22,28,21
L33 1ZF,L33,1ZF,66,29,37,27
L33 1ZG,L33,1ZG,80,44,36,30
L33 1ZH,L33,1ZH,20,8,12,6
L33 1ZJ,L33,1ZJ,24,10,14,8
L33 1ZL,L33,1ZL,7,3,4,3
L33 1ZN,L33,1ZN,17,10,7,6
L33 1ZP,L33,1ZP,21,9,12,7
L33 1ZQ,L33,1ZQ,51,24,27,15
L33 1ZR,L33,1ZR,77,40,37,30
L33 1ZS,L33,1ZS,43,19,24,16
L33 1ZT,L33,1ZT,86,40,46,32
L33 1ZW,L33,1ZW,42,21,21,15
L33 1ZX,L33,1ZX,38,21,17,12
L33 1ZY,L33,1ZY,4,2,2,3
L33 1ZZ,L33,1ZZ,45,20,25,23
L33 2DA,L33,2DA,64,30,34,24
L33 2DB,L33,2DB,69,35,34,29
L33 2DD,L33,2DD,51,30,21,24
L33 2DE,L33,2DE,40,13,27,12
L33 2DF,L33,2DF,46,22,24,19
L33 2DG,L33,2DG,81,34,47,30
L33 2DH,L33,2DH,62,32,30,30
L33 2DJ,L33,2DJ,81,34,47,34
L33 2DL,L33,2DL,34,17,17,13
L33 2DN,L33,2DN,41,16,25,20
L33 2DP,L33,2DP,29,13,16,13
L33 2DQ,L33,2DQ,52,19,33,15
L33 2DR,L33,2DR,30,14,16,13
L33 2DS,L33,2DS,72,30,42,34
L33 2DT,L33,2DT,27,11,16,11
L33 2DU,L33,2DU,26,15,11,9
L33 2DW,L33,2DW,44,21,23,18
L33 2DX,L33,2DX,53,28,25,17
L33 2DY,L33,2DY,33,15,18,15
L33 2DZ,L33,2DZ,44,25,19,18
L33 2EB,L33,2EB,5,2,3,2
L33 2ED,L33,2ED,60,28,32,23
L33 2EE,L33,2EE,46,21,25,18
L33 2EF,L33,2EF,74,34,40,31
L33 2EH,L33,2EH,39,23,16,31
L33 3AD,L33,3AD,3,1,2,1
L33 3AE,L33,3AE,18,8,10,6
L33 3AF,L33,3AF,2,1,1,1
L33 3AH,L33,3AH,12,5,7,5
L33 3AJ,L33,3AJ,9,6,3,4
L33 3AL,L33,3AL,4,1,3,1
L33 3AN,L33,3AN,3,1,2,1
L33 3AP,L33,3AP,9,4,5,5
L33 3AQ,L33,3AQ,2,1,1,1
L33 3AR,L33,3AR,4,2,2,2
L33 3AT,L33,3AT,12,7,5,6
L33 3AU,L33,3AU,8,4,4,2
L33 4BA,L33,4BA,24,12,12,11
L33 4BB,L33,4BB,36,20,16,16
L33 4BD,L33,4BD,73,37,36,28
L33 4DA,L33,4DA,50,28,22,21
L33 4DB,L33,4DB,20,10,10,9
L33 4DD,L33,4DD,81,35,46,22
L33 4DE,L33,4DE,52,25,27,19
L33 4DF,L33,4DF,59,26,33,18
L33 4DG,L33,4DG,67,30,37,28
L33 4DH,L33,4DH,54,24,30,21
L33 4DJ,L33,4DJ,10,4,6,3
L33 4DL,L33,4DL,72,36,36,29
L33 4DP,L33,4DP,9,5,4,3
L33 4DQ,L33,4DQ,207,102,105,83
L33 4DR,L33,4DR,85,39,46,34
L33 4DS,L33,4DS,64,30,34,25
L33 4DT,L33,4DT,60,29,31,17
L33 4DU,L33,4DU,101,50,51,35
L33 4DW,L33,4DW,96,43,53,40
L33 4DX,L33,4DX,46,23,23,19
L33 4DY,L33,4DY,43,16,27,16
L33 4DZ,L33,4DZ,71,35,36,20
L33 4EA,L33,4EA,58,29,29,17
L33 4EB,L33,4EB,51,23,28,14
L33 4EG,L33,4EG,101,47,54,37
L33 4EH,L33,4EH,44,17,27,17
L33 4EJ,L33,4EJ,27,13,14,12
L33 4EL,L33,4EL,37,18,19,16
L33 4EN,L33,4EN,29,11,18,12
L33 4EP,L33,4EP,31,14,17,12
L33 4EQ,L33,4EQ,78,33,45,28
L33 4ER,L33,4ER,27,16,11,10
L33 4ES,L33,4ES,72,33,39,27
L33 4ET,L33,4ET,46,23,23,22
L33 4EU,L33,4EU,17,7,10,5
L33 4EW,L33,4EW,10,5,5,5
L33 4EX,L33,4EX,56,28,28,21
L33 4EY,L33,4EY,25,10,15,8
L33 4EZ,L33,4EZ,42,19,23,13
L33 4FB,L33,4FB,51,24,27,16
L33 4FD,L33,4FD,70,37,33,22
L33 4FE,L33,4FE,93,45,48,31
L33 4GA,L33,4GA,48,23,25,16
L33 4GB,L33,4GB,105,50,55,36
L33 4HA,L33,4HA,50,20,30,14
L33 4HB,L33,4HB,20,10,10,4
L33 4HD,L33,4HD,33,16,17,11
L33 4HE,L33,4HE,29,13,16,10
L33 4HF,L33,4HF,49,28,21,19
L33 4HG,L33,4HG,95,45,50,35
L33 4HJ,L33,4HJ,52,27,25,15
L33 4HL,L33,4HL,44,29,15,15
L33 4HP,L33,4HP,48,19,29,19
L33 4HR,L33,4HR,52,22,30,24
L33 4HS,L33,4HS,200,107,93,79
L33 4HT,L33,4HT,29,15,14,13
L33 4HU,L33,4HU,42,21,21,15
L33 4HW,L33,4HW,28,12,16,16
L33 4HX,L33,4HX,26,14,12,10
L33 4JA,L33,4JA,37,16,21,10
L33 4JB,L33,4JB,44,20,24,16
L33 4JD,L33,4JD,85,40,45,24
L33 4JE,L33,4JE,76,38,38,28
L33 4XX,L33,4XX,33,15,18,12
L33 4YA,L33,4YA,1,0,1,1
L33 4YB,L33,4YB,28,16,12,12
L33 4YD,L33,4YD,9,6,3,3
L33 4YE,L33,4YE,95,46,49,28
L33 4YF,L33,4YF,4,2,2,2
L33 4YG,L33,4YG,7,3,4,4
L33 4YH,L33,4YH,12,5,7,7
L33 4YQ,L33,4YQ,8,2,6,3
L33 4YS,L33,4YS,75,36,39,31
L33 4YT,L33,4YT,20,9,11,8
L33 4YU,L33,4YU,122,68,54,45
L33 4YX,L33,4YX,92,43,49,33
L33 4YY,L33,4YY,78,41,37,27
L33 4YZ,L33,4YZ,80,42,38,31
L33 5XA,L33,5XA,62,22,40,29
L33 5XB,L33,5XB,50,22,28,24
L33 5XD,L33,5XD,3,2,1,2
L33 5XE,L33,5XE,37,20,17,15
L33 5XF,L33,5XF,22,10,12,9
L33 5XG,L33,5XG,53,24,29,20
L33 5XH,L33,5XH,27,16,11,8
L33 5XJ,L33,5XJ,62,33,29,21
L33 5XL,L33,5XL,15,7,8,6
L33 5XN,L33,5XN,47,24,23,16
L33 5XP,L33,5XP,72,34,38,26
L33 5XQ,L33,5XQ,82,38,44,33
L33 5XR,L33,5XR,37,18,19,19
L33 5XS,L33,5XS,51,19,32,24
L33 5XT,L33,5XT,58,25,33,20
L33 5XU,L33,5XU,34,11,23,18
L33 5XW,L33,5XW,49,24,25,17
L33 5XX,L33,5XX,80,27,53,38
L33 5XY,L33,5XY,57,28,29,24
L33 5XZ,L33,5XZ,47,24,23,16
L33 5YA,L33,5YA,15,7,8,9
L33 5YB,L33,5YB,86,36,50,35
L33 5YD,L33,5YD,25,12,13,10
L33 5YF,L33,5YF,44,22,22,20
L33 5YG,L33,5YG,27,12,15,15
L33 5YH,L33,5YH,33,12,21,12
L33 5YJ,L33,5YJ,47,20,27,27
L33 5YL,L33,5YL,11,4,7,4
L33 5YQ,L33,5YQ,25,15,10,12
L33 6UA,L33,6UA,30,15,15,10
L33 6UB,L33,6UB,2,1,1,1
L33 6UD,L33,6UD,7,5,2,2
L33 6UE,L33,6UE,83,32,51,31
L33 6UF,L33,6UF,63,29,34,23
L33 6UG,L33,6UG,50,28,22,20
L33 6UH,L33,6UH,20,7,13,9
L33 6UJ,L33,6UJ,16,9,7,11
L33 6UL,L33,6UL,29,11,18,14
L33 6UN,L33,6UN,28,12,16,12
L33 6UP,L33,6UP,13,5,8,6
L33 6UQ,L33,6UQ,111,45,66,33
L33 6US,L33,6US,41,19,22,16
L33 6UT,L33,6UT,35,14,21,17
L33 6UU,L33,6UU,37,19,18,14
L33 6UW,L33,6UW,37,13,24,18
L33 6UX,L33,6UX,28,12,16,15
L33 6UY,L33,6UY,47,19,28,22
L33 6UZ,L33,6UZ,64,29,35,23
L33 6XA,L33,6XA,19,6,13,10
L33 6XB,L33,6XB,75,32,43,34
L33 6XD,L33,6XD,41,19,22,25
L33 6XE,L33,6XE,30,25,5,25
L33 6XJ,L33,6XJ,28,12,16,7
L33 6XN,L33,6XN,3,2,1,2
L33 6XP,L33,6XP,23,14,9,10
L33 6XQ,L33,6XQ,44,23,21,17
L33 6XR,L33,6XR,3,2,1,2
L33 6XS,L33,6XS,8,1,7,4
L33 6XT,L33,6XT,75,38,37,32
L33 6XU,L33,6XU,32,14,18,16
L33 6XW,L33,6XW,39,12,27,18
L33 6XY,L33,6XY,47,21,26,20
L33 6XZ,L33,6XZ,43,18,25,16
L33 6YB,L33,6YB,80,31,49,32
L33 6YD,L33,6YD,41,18,23,24
L33 6YE,L33,6YE,30,16,14,14
L33 6YF,L33,6YF,71,30,41,25
L33 6YH,L33,6YH,42,22,20,12
L33 6YN,L33,6YN,23,10,13,9
L33 6YQ,L33,6YQ,47,14,33,36
L33 7UA,L33,7UA,2,1,1,1
L33 7UY,L33,7UY,1,0,1,1
L33 7XB,L33,7XB,6,3,3,3
L33 7XE,L33,7XE,3,1,2,2
L33 7XX,L33,7XX,49,25,24,19
L33 7XY,L33,7XY,56,27,29,19
L33 7XZ,L33,7XZ,35,20,15,12
L33 7YA,L33,7YA,67,32,35,29
L33 8WW,L33,8WW,43,24,19,23
L33 8WX,L33,8WX,34,17,17,14
L33 8WY,L33,8WY,108,63,45,68
L33 8WZ,L33,8WZ,89,45,44,57
L33 8XB,L33,8XB,21,11,10,7
L33 8XE,L33,8XE,54,30,24,26
L33 8XR,L33,8XR,47,25,22,19
L33 8XS,L33,8XS,25,9,16,10
L33 8XT,L33,8XT,15,7,8,6
L33 8XU,L33,8XU,11,5,6,7
L33 8XX,L33,8XX,39,18,21,18
L33 8XY,L33,8XY,61,31,30,49
L33 8XZ,L33,8XZ,73,36,37,48
L33 8YA,L33,8YA,54,36,18,43
L33 8YB,L33,8YB,29,10,19,15
L33 8YD,L33,8YD,54,27,27,20
L33 8YE,L33,8YE,24,14,10,12
L33 8YF,L33,8YF,11,4,7,6
L33 8YH,L33,8YH,18,10,8,5
L33 8YJ,L33,8YJ,13,8,5,6
L33 8YL,L33,8YL,21,9,12,10
L33 8YN,L33,8YN,15,7,8,7
L33 8YP,L33,8YP,42,19,23,18
L33 8YQ,L33,8YQ,77,35,42,31
L33 8YR,L33,8YR,50,10,40,0
L33 8YW,L33,8YW,37,21,16,15
L33 9TA,L33,9TA,3,1,2,2
L33 9TB,L33,9TB,51,24,27,19
L33 9TD,L33,9TD,47,20,27,10
L33 9TF,L33,9TF,39,17,22,15
L33 9TG,L33,9TG,33,14,19,12
L33 9TH,L33,9TH,13,4,9,4
L33 9TJ,L33,9TJ,12,7,5,6
L33 9TL,L33,9TL,53,23,30,22
L33 9TN,L33,9TN,30,14,16,10
L33 9TP,L33,9TP,58,22,36,25
L33 9TQ,L33,9TQ,47,21,26,19
L33 9TR,L33,9TR,28,13,15,11
L33 9TS,L33,9TS,21,8,13,10
L33 9TT,L33,9TT,45,14,31,19
L33 9TW,L33,9TW,27,14,13,9
L33 9TX,L33,9TX,26,6,20,11
L33 9TY,L33,9TY,21,8,13,14
L33 9TZ,L33,9TZ,33,12,21,13
L33 9UA,L33,9UA,30,11,19,11
L33 9UB,L33,9UB,55,26,29,19
L33 9UD,L33,9UD,91,40,51,37
L33 9UE,L33,9UE,46,20,26,18
L33 9UF,L33,9UF,58,25,33,27
L33 9UG,L33,9UG,61,31,30,22
L33 9UH,L33,9UH,29,15,14,12
L33 9UJ,L33,9UJ,31,14,17,12
L33 9UL,L33,9UL,24,10,14,6
L33 9UN,L33,9UN,73,24,49,26
L33 9UQ,L33,9UQ,28,13,15,10
L33 9US,L33,9US,36,17,19,14
L33 9UT,L33,9UT,8,5,3,4
L33 9UX,L33,9UX,21,11,10,5
L33 9UY,L33,9UY,46,22,24,18
L33 9UZ,L33,9UZ,68,27,41,26
L33 9XB,L33,9XB,111,40,71,36
L33 9XD,L33,9XD,34,14,20,15
L33 9XE,L33,9XE,93,36,57,36
L33 9XF,L33,9XF,20,6,14,8
L33 9XG,L33,9XG,49,22,27,24
L33 9XH,L33,9XH,5,1,4,2
L33 9XL,L33,9XL,22,10,12,6
L33 9XP,L33,9XP,38,17,21,12
L33 9XQ,L33,9XQ,97,36,61,32
L33 9XS,L33,9XS,18,7,11,9
L33 9XT,L33,9XT,39,11,28,12
L33 9XW,L33,9XW,43,21,22,14
L34 0BA,L34,0BA,15,9,6,12
L34 0BB,L34,0BB,21,12,9,14
L34 0EA,L34,0EA,26,10,16,11
L34 0EB,L34,0EB,86,44,42,39
L34 0ED,L34,0ED,104,55,49,45
L34 0EE,L34,0EE,4,1,3,3
L34 0EF,L34,0EF,44,22,22,24
L34 0EG,L34,0EG,88,50,38,36
L34 0EH,L34,0EH,79,42,37,32
L34 0EJ,L34,0EJ,56,25,31,25
L34 0EL,L34,0EL,83,41,42,36
L34 0EN,L34,0EN,16,7,9,7
L34 0EP,L34,0EP,13,5,8,8
L34 0EQ,L34,0EQ,16,7,9,5
L34 0ER,L34,0ER,45,23,22,17
L34 0ES,L34,0ES,107,53,54,36
L34 0ET,L34,0ET,3,1,2,3
L34 0EU,L34,0EU,59,27,32,28
L34 0EW,L34,0EW,13,6,7,6
L34 0EY,L34,0EY,25,13,12,8
L34 0EZ,L34,0EZ,17,7,10,13
L34 0HA,L34,0HA,15,7,8,6
L34 0HB,L34,0HB,10,5,5,7
L34 0HD,L34,0HD,6,5,1,2
L34 0HE,L34,0HE,34,8,26,18
L34 0HF,L34,0HF,110,56,54,34
L34 0HG,L34,0HG,72,36,36,28
L34 0HH,L34,0HH,42,23,19,22
L34 0HJ,L34,0HJ,21,10,11,8
L34 0HL,L34,0HL,22,14,8,11
L34 0HN,L34,0HN,67,33,34,27
L34 0HP,L34,0HP,101,46,55,42
L34 0HQ,L34,0HQ,56,26,30,20
L34 0HR,L34,0HR,21,11,10,7
L34 0HS,L34,0HS,66,30,36,30
L34 0HT,L34,0HT,75,32,43,34
L34 0HU,L34,0HU,23,10,13,8
L34 0HW,L34,0HW,100,48,52,42
L34 0HX,L34,0HX,11,6,5,4
L34 0HY,L34,0HY,52,27,25,22
L34 0HZ,L34,0HZ,53,26,27,25
L34 0JA,L34,0JA,4,2,2,2
L34 0JB,L34,0JB,4,1,3,3
L34 0JD,L34,0JD,27,13,14,11
L34 0JE,L34,0JE,28,14,14,13
L34 0JF,L34,0JF,20,9,11,8
L34 0JG,L34,0JG,15,7,8,6
L34 0JH,L34,0JH,34,15,19,14
L34 0JN,L34,0JN,5,4,1,2
L34 0JQ,L34,0JQ,104,53,51,35
L34 0JW,L34,0JW,11,5,6,4
L34 1LA,L34,1LA,16,10,6,13
L34 1LB,L34,1LB,45,26,19,16
L34 1LD,L34,1LD,34,19,15,12
L34 1LE,L34,1LE,32,16,16,10
L34 1LH,L34,1LH,49,24,25,18
L34 1LJ,L34,1LJ,40,24,16,16
L34 1LL,L34,1LL,37,20,17,11
L34 1LN,L34,1LN,40,21,19,18
L34 1LP,L34,1LP,40,19,21,14
L34 1LQ,L34,1LQ,40,24,16,21
L34 1LR,L34,1LR,11,5,6,6
L34 1LS,L34,1LS,17,8,9,10
L34 1LT,L34,1LT,27,10,17,23
L34 1LU,L34,1LU,19,9,10,15
L34 1LW,L34,1LW,40,22,18,16
L34 1LX,L34,1LX,25,13,12,9
L34 1LY,L34,1LY,52,24,28,24
L34 1LZ,L34,1LZ,88,46,42,25
L34 1NA,L34,1NA,70,39,31,26
L34 1NB,L34,1NB,67,35,32,26
L34 1ND,L34,1ND,25,13,12,14
L34 1NE,L34,1NE,27,14,13,11
L34 1NF,L34,1NF,35,20,15,15
L34 1NG,L34,1NG,58,26,32,22
L34 1NH,L34,1NH,50,39,11,33
L34 1NJ,L34,1NJ,17,13,4,16
L34 1NL,L34,1NL,15,8,7,8
L34 1NQ,L34,1NQ,70,36,34,30
L34 1NR,L34,1NR,6,4,2,4
L34 1NS,L34,1NS,33,18,15,13
L34 1NT,L34,1NT,39,19,20,18
L34 1NU,L34,1NU,47,23,24,22
L34 1NX,L34,1NX,30,14,16,10
L34 1NY,L34,1NY,56,20,36,45
L34 1PL,L34,1PL,14,7,7,5
L34 1PN,L34,1PN,162,80,82,49
L34 1PP,L34,1PP,25,14,11,9
L34 1PR,L34,1PR,45,23,22,17
L34 1PS,L34,1PS,23,11,12,12
L34 1PT,L34,1PT,25,11,14,10
L34 1PU,L34,1PU,58,32,26,20
L34 1PW,L34,1PW,13,5,8,6
L34 1PX,L34,1PX,74,35,39,26
L34 1PY,L34,1PY,43,19,24,15
L34 1PZ,L34,1PZ,32,15,17,15
L34 1QA,L34,1QA,3,2,1,1
L34 1QB,L34,1QB,120,61,59,36
L34 1QD,L34,1QD,107,54,53,31
L34 1QF,L34,1QF,28,14,14,8
L34 1QH,L34,1QH,36,20,16,13
L34 1QL,L34,1QL,3,1,2,1
L34 2GA,L34,2GA,42,17,25,18
L34 2GD,L34,2GD,22,10,12,10
L34 2QA,L34,2QA,19,7,12,9
L34 2QB,L34,2QB,72,38,34,29
L34 2QD,L34,2QD,69,30,39,40
L34 2QE,L34,2QE,36,19,17,13
L34 2QG,L34,2QG,52,23,29,22
L34 2QH,L34,2QH,16,9,7,7
L34 2QL,L34,2QL,102,47,55,23
L34 2QN,L34,2QN,35,14,21,13
L34 2QP,L34,2QP,61,29,32,23
L34 2QQ,L34,2QQ,64,29,35,30
L34 2QR,L34,2QR,17,7,10,7
L34 2QS,L34,2QS,50,28,22,20
L34 2QT,L34,2QT,19,10,9,8
L34 2QU,L34,2QU,13,5,8,7
L34 2QW,L34,2QW,48,25,23,16
L34 2QX,L34,2QX,18,9,9,7
L34 2QY,L34,2QY,62,27,35,26
L34 2QZ,L34,2QZ,62,29,33,25
L34 2RA,L34,2RA,38,21,17,15
L34 2RB,L34,2RB,10,7,3,5
L34 2RD,L34,2RD,52,21,31,28
L34 2RE,L34,2RE,56,27,29,19
L34 2RF,L34,2RF,58,26,32,27
L34 2RG,L34,2RG,50,26,24,21
L34 2RH,L34,2RH,62,33,29,23
L34 2RJ,L34,2RJ,25,12,13,9
L34 2RL,L34,2RL,30,15,15,12
L34 2RN,L34,2RN,88,43,45,32
L34 2RP,L34,2RP,50,20,30,23
L34 2RQ,L34,2RQ,62,29,33,24
L34 2RR,L34,2RR,58,25,33,21
L34 2RS,L34,2RS,64,31,33,25
L34 2RT,L34,2RT,98,45,53,40
L34 2RU,L34,2RU,19,9,10,9
L34 2RW,L34,2RW,60,28,32,20
L34 2RX,L34,2RX,66,32,34,25
L34 2RY,L34,2RY,64,28,36,26
L34 2RZ,L34,2RZ,72,36,36,29
L34 2SA,L34,2SA,44,19,25,23
L34 2SB,L34,2SB,52,21,31,30
L34 2SD,L34,2SD,60,33,27,31
L34 2SE,L34,2SE,48,19,29,23
L34 2SF,L34,2SF,42,19,23,23
L34 2SG,L34,2SG,95,45,50,32
L34 2SJ,L34,2SJ,70,34,36,30
L34 2SL,L34,2SL,51,17,34,41
L34 2SN,L34,2SN,51,26,25,21
L34 2SP,L34,2SP,18,11,7,10
L34 2SQ,L34,2SQ,45,23,22,14
L34 2SR,L34,2SR,87,50,37,29
L34 2SS,L34,2SS,65,31,34,27
L34 2ST,L34,2ST,77,29,48,30
L34 2SU,L34,2SU,54,27,27,22
L34 2SW,L34,2SW,50,23,27,23
L34 2SX,L34,2SX,40,22,18,13
L34 2SY,L34,2SY,73,37,36,27
L34 2SZ,L34,2SZ,55,27,28,21
L34 2TA,L34,2TA,77,36,41,34
L34 2TB,L34,2TB,44,15,29,24
L34 2TD,L34,2TD,83,43,40,28
L34 2TE,L34,2TE,51,24,27,27
L34 2TF,L34,2TF,44,22,22,30
L34 2TG,L34,2TG,69,32,37,29
L34 2TH,L34,2TH,11,7,4,3
L34 2TL,L34,2TL,75,38,37,29
L34 2TN,L34,2TN,15,8,7,9
L34 2TP,L34,2TP,5,4,1,4
L34 2TQ,L34,2TQ,22,13,9,8
L34 2TS,L34,2TS,6,2,4,5
L34 2TT,L34,2TT,6,3,3,3
L34 2TU,L34,2TU,64,27,37,25
L34 2UG,L34,2UG,11,6,5,5
L34 2UH,L34,2UH,23,10,13,16
L34 2UQ,L34,2UQ,41,21,20,15
L34 3LD,L34,3LD,45,23,22,1
L34 3LE,L34,3LE,1,1,0,1
L34 3LF,L34,3LF,20,9,11,10
L34 3LG,L34,3LG,9,4,5,6
L34 3LL,L34,3LL,14,9,5,8
L34 3LN,L34,3LN,52,22,30,7
L34 3LP,L34,3LP,40,19,21,18
L34 3LR,L34,3LR,51,27,24,20
L34 3LS,L34,3LS,39,15,24,23
L34 3LT,L34,3LT,65,28,37,34
L34 3LU,L34,3LU,9,2,7,7
L34 3LW,L34,3LW,32,16,16,14
L34 3LX,L34,3LX,1,0,1,1
L34 3LY,L34,3LY,64,37,27,40
L34 3LZ,L34,3LZ,36,16,20,26
L34 3NA,L34,3NA,64,37,27,22
L34 3NB,L34,3NB,26,10,16,8
L34 3ND,L34,3ND,3,1,2,2
L34 3NE,L34,3NE,17,8,9,9
L34 4AD,L34,4AD,14,6,8,8
L34 4AE,L34,4AE,44,22,22,23
L34 4AF,L34,4AF,8,5,3,3
L34 4AG,L34,4AG,5,3,2,3
L34 4AH,L34,4AH,23,12,11,9
L34 4AJ,L34,4AJ,16,9,7,6
L34 4AN,L34,4AN,3,1,2,2
L34 4AP,L34,4AP,7,2,5,6
L34 4AQ,L34,4AQ,23,10,13,9
L34 4AR,L34,4AR,5,3,2,2
L34 4AT,L34,4AT,1,1,0,1
L34 5NB,L34,5NB,17,7,10,10
L34 5ND,L34,5ND,103,49,54,40
L34 5NR,L34,5NR,97,47,50,37
L34 5NT,L34,5NT,11,4,7,5
L34 5NU,L34,5NU,26,11,15,9
L34 5PB,L34,5PB,35,16,19,24
L34 5PD,L34,5PD,63,24,39,37
L34 5PE,L34,5PE,58,28,30,47
L34 5PF,L34,5PF,55,27,28,27
L34 5PH,L34,5PH,38,16,22,20
L34 5PJ,L34,5PJ,18,10,8,12
L34 5QA,L34,5QA,8,6,2,4
L34 5QE,L34,5QE,9,6,3,6
L34 5QH,L34,5QH,5,4,1,2
L34 5QN,L34,5QN,17,12,5,12
L34 5QP,L34,5QP,5,4,1,3
L34 5QU,L34,5QU,21,11,10,11
L34 5QX,L34,5QX,36,17,19,18
L34 5QY,L34,5QY,12,5,7,7
L34 5RB,L34,5RB,12,7,5,4
L34 5RD,L34,5RD,15,7,8,7
L34 5RE,L34,5RE,2,1,1,1
L34 5RF,L34,5RF,7,3,4,4
L34 5RG,L34,5RG,19,11,8,8
L34 5RJ,L34,5RJ,24,13,11,19
L34 5RL,L34,5RL,22,13,9,13
L34 5RN,L34,5RN,32,17,15,25
L34 5RQ,L34,5RQ,20,10,10,15
L34 5RS,L34,5RS,20,13,7,13
L34 5RU,L34,5RU,33,18,15,24
L34 5RW,L34,5RW,41,19,22,20
L34 5RY,L34,5RY,45,18,27,27
L34 5SA,L34,5SA,1,0,1,1
L34 5SB,L34,5SB,12,10,2,10
L34 5SE,L34,5SE,20,8,12,9
L34 5SF,L34,5SF,7,3,4,4
L34 5SG,L34,5SG,11,4,7,6
L34 5SH,L34,5SH,26,15,11,15
L34 5SJ,L34,5SJ,51,22,29,24
L34 5SL,L34,5SL,53,21,32,24
L34 5SN,L34,5SN,28,19,9,16
L34 5SQ,L34,5SQ,25,13,12,11
L34 5SS,L34,5SS,19,13,6,7
L34 5ST,L34,5ST,22,14,8,14
L34 5SU,L34,5SU,25,14,11,12
L34 5SW,L34,5SW,5,4,1,4
L34 5SX,L34,5SX,16,6,10,8
L34 5TB,L34,5TB,8,3,5,6
L34 5TH,L34,5TH,28,13,15,19
L34 5UB,L34,5UB,17,6,11,13
L34 5UD,L34,5UD,35,18,17,18
L34 5UN,L34,5UN,2,1,1,1
L34 6HA,L34,6HA,4,1,3,1
L34 6HB,L34,6HB,60,22,38,32
L34 6HD,L34,6HD,40,19,21,24
L34 6HE,L34,6HE,16,9,7,13
L34 6HF,L34,6HF,8,6,2,4
L34 6HG,L34,6HG,5,3,2,2
L34 6HH,L34,6HH,32,12,20,26
L34 6HJ,L34,6HJ,20,5,15,14
L34 6HL,L34,6HL,10,4,6,9
L34 6HN,L34,6HN,41,17,24,17
L34 6HP,L34,6HP,39,19,20,15
L34 6HQ,L34,6HQ,9,4,5,5
L34 6HR,L34,6HR,30,17,13,10
L34 6HS,L34,6HS,23,10,13,9
L34 6HT,L34,6HT,9,2,7,4
L34 6HU,L34,6HU,65,31,34,37
L34 6HW,L34,6HW,16,6,10,9
L34 6HX,L34,6HX,19,7,12,11
L34 6HY,L34,6HY,18,9,9,15
L34 6HZ,L34,6HZ,29,16,13,13
L34 6JA,L34,6JA,74,38,36,36
L34 6JB,L34,6JB,57,28,29,29
L34 6JD,L34,6JD,45,18,27,22
L34 6JE,L34,6JE,55,24,31,24
L34 6JF,L34,6JF,27,13,14,24
L34 6JG,L34,6JG,62,28,34,39
L34 6JH,L34,6JH,33,13,20,19
L34 6JJ,L34,6JJ,35,15,20,15
L34 6JL,L34,6JL,15,6,9,8
L34 6JN,L34,6JN,16,6,10,10
L34 6JP,L34,6JP,24,12,12,12
L34 6JQ,L34,6JQ,19,11,8,6
L34 6JR,L34,6JR,3,1,2,2
L34 6JS,L34,6JS,33,14,19,20
L34 6JT,L34,6JT,48,26,22,21
L34 6JU,L34,6JU,21,8,13,10
L34 6JW,L34,6JW,33,15,18,12
L34 6LB,L34,6LB,23,9,14,8
L34 6LD,L34,6LD,61,32,29,20
L34 6LE,L34,6LE,100,47,53,38
L34 6LF,L34,6LF,42,20,22,15
L34 6LG,L34,6LG,79,38,41,28
L34 6LJ,L34,6LJ,39,15,24,13
L34 6LL,L34,6LL,67,38,29,28
L34 6LN,L34,6LN,63,35,28,27
L34 6LP,L34,6LP,16,8,8,6
L34 6LR,L34,6LR,7,3,4,4
L34 6LU,L34,6LU,8,4,4,5
L34 6LW,L34,6LW,37,17,20,14
L34 6ND,L34,6ND,11,5,6,6
L34 6NE,L34,6NE,20,11,9,12
L34 6NF,L34,6NF,19,12,7,10
L34 6NJ,L34,6NJ,18,11,7,11
L34 6NL,L34,6NL,8,3,5,5
L34 7HA,L34,7HA,9,6,3,3
L34 7HB,L34,7HB,16,7,9,7
L34 7HD,L34,7HD,9,2,7,3
L34 7HE,L34,7HE,6,3,3,2
L34 7HF,L34,7HF,11,5,6,4
L34 7HG,L34,7HG,28,12,16,12
L34 7HQ,L34,7HQ,4,2,2,1
L34 8HA,L34,8HA,8,4,4,3
L34 8HB,L34,8HB,87,44,43,35
L34 8HE,L34,8HE,14,8,6,7
L34 8HF,L34,8HF,6,3,3,3
L34 8HG,L34,8HG,6,4,2,4
L34 8HH,L34,8HH,6,4,2,2
L34 8HJ,L34,8HJ,4,2,2,2
L34 8HL,L34,8HL,4,3,1,1
L34 8HN,L34,8HN,2,0,2,1
L34 8HQ,L34,8HQ,9,4,5,4
L34 8HW,L34,8HW,39,19,20,11
L34 9BA,L34,9BA,10,2,8,2
L34 9BD,L34,9BD,25,11,14,8
L34 9EA,L34,9EA,39,18,21,16
L34 9EB,L34,9EB,7,6,1,6
L34 9ED,L34,9ED,5,4,1,2
L34 9EE,L34,9EE,15,7,8,5
L34 9EF,L34,9EF,96,51,45,43
L34 9EG,L34,9EG,5,3,2,4
L34 9EH,L34,9EH,34,14,20,20
L34 9EJ,L34,9EJ,25,8,17,10
L34 9EL,L34,9EL,4,2,2,2
L34 9EN,L34,9EN,5,3,2,2
L34 9EQ,L34,9EQ,7,4,3,3
L34 9ER,L34,9ER,9,6,3,5
L34 9ES,L34,9ES,2,1,1,1
L34 9EY,L34,9EY,1,0,1,1
L34 9GY,L34,9GY,7,3,4,2
L35 0LA,L35,0LA,23,9,14,15
L35 0LE,L35,0LE,16,7,9,8
L35 0LF,L35,0LF,62,21,41,8
L35 0LH,L35,0LH,58,29,29,29
L35 0LJ,L35,0LJ,8,4,4,3
L35 0LN,L35,0LN,22,11,11,10
L35 0LP,L35,0LP,5,3,2,3
L35 0LQ,L35,0LQ,36,23,13,13
L35 0LR,L35,0LR,2,2,0,2
L35 0LS,L35,0LS,25,13,12,10
L35 0LT,L35,0LT,46,17,29,33
L35 0LU,L35,0LU,16,8,8,8
L35 0LW,L35,0LW,23,12,11,8
L35 0LX,L35,0LX,13,5,8,8
L35 0LY,L35,0LY,9,4,5,6
L35 0LZ,L35,0LZ,19,10,9,9
L35 0NA,L35,0NA,10,3,7,5
L35 0NB,L35,0NB,49,26,23,20
L35 0ND,L35,0ND,22,7,15,11
L35 0NE,L35,0NE,56,24,32,20
L35 0NF,L35,0NF,2,1,1,1
L35 0NG,L35,0NG,27,11,16,18
L35 0NH,L35,0NH,34,17,17,16
L35 0NJ,L35,0NJ,22,10,12,14
L35 0NL,L35,0NL,38,19,19,17
L35 0NN,L35,0NN,55,26,29,23
L35 0NP,L35,0NP,75,36,39,31
L35 0NQ,L35,0NQ,36,15,21,19
L35 0NR,L35,0NR,75,32,43,38
L35 0NS,L35,0NS,54,25,29,27
L35 0NT,L35,0NT,16,7,9,6
L35 0NU,L35,0NU,42,21,21,16
L35 0NW,L35,0NW,53,24,29,22
L35 0NX,L35,0NX,42,23,19,16
L35 0NY,L35,0NY,108,53,55,46
L35 0NZ,L35,0NZ,85,38,47,35
L35 0PA,L35,0PA,118,60,58,45
L35 0PB,L35,0PB,21,8,13,10
L35 0PE,L35,0PE,26,14,12,10
L35 0PF,L35,0PF,14,5,9,11
L35 0PG,L35,0PG,19,9,10,8
L35 0PJ,L35,0PJ,37,19,18,16
L35 0PL,L35,0PL,32,15,17,12
L35 0PN,L35,0PN,34,14,20,16
L35 0PP,L35,0PP,28,14,14,15
L35 0PQ,L35,0PQ,85,38,47,40
L35 0PR,L35,0PR,12,6,6,4
L35 0PS,L35,0PS,44,23,21,16
L35 0PT,L35,0PT,36,14,22,16
L35 0PU,L35,0PU,74,35,39,27
L35 0PW,L35,0PW,54,26,28,22
L35 0PX,L35,0PX,43,21,22,19
L35 0PY,L35,0PY,54,24,30,23
L35 0PZ,L35,0PZ,22,8,14,9
L35 0QA,L35,0QA,17,7,10,8
L35 0QB,L35,0QB,56,27,29,24
L35 0QD,L35,0QD,39,19,20,14
L35 0QE,L35,0QE,31,14,17,12
L35 0QF,L35,0QF,18,10,8,6
L35 0QG,L35,0QG,57,28,29,25
L35 0QH,L35,0QH,78,39,39,35
L35 0QJ,L35,0QJ,32,19,13,19
L35 0QL,L35,0QL,11,5,6,4
L35 0QN,L35,0QN,26,13,13,11
L35 0QP,L35,0QP,42,21,21,18
L35 0QQ,L35,0QQ,39,22,17,17
L35 0QR,L35,0QR,110,54,56,49
L35 0QS,L35,0QS,5,3,2,5
L35 0QT,L35,0QT,26,11,15,17
L35 0QU,L35,0QU,51,24,27,20
L35 0QW,L35,0QW,14,9,5,7
L35 0QX,L35,0QX,29,16,13,14
L35 0QY,L35,0QY,22,10,12,9
L35 0RG,L35,0RG,17,9,8,6
L35 1QA,L35,1QA,24,12,12,9
L35 1QB,L35,1QB,17,11,6,9
L35 1QD,L35,1QD,42,19,23,18
L35 1QE,L35,1QE,13,8,5,5
L35 1QF,L35,1QF,6,3,3,3
L35 1QG,L35,1QG,11,5,6,5
L35 1QH,L35,1QH,34,15,19,12
L35 1QJ,L35,1QJ,32,12,20,11
L35 1QL,L35,1QL,62,29,33,21
L35 1QN,L35,1QN,10,3,7,5
L35 1QQ,L35,1QQ,6,1,5,2
L35 1QR,L35,1QR,9,5,4,3
L35 1QU,L35,1QU,9,5,4,3
L35 1QW,L35,1QW,7,1,6,4
L35 1QX,L35,1QX,27,17,10,11
L35 1QY,L35,1QY,11,8,3,3
L35 1QZ,L35,1QZ,10,7,3,2
L35 1RA,L35,1RA,4,2,2,2
L35 1RB,L35,1RB,10,5,5,4
L35 1RD,L35,1RD,7,4,3,4
L35 1RE,L35,1RE,16,9,7,8
L35 1RF,L35,1RF,5,4,1,2
L35 1RG,L35,1RG,8,4,4,4
L35 1RH,L35,1RH,50,27,23,23
L35 1RJ,L35,1RJ,149,75,74,63
L35 1RL,L35,1RL,76,37,39,36
L35 1RN,L35,1RN,37,17,20,18
L35 1RP,L35,1RP,141,64,77,64
L35 1RQ,L35,1RQ,6,3,3,2
L35 1RR,L35,1RR,48,21,27,32
L35 1RS,L35,1RS,40,22,18,17
L35 1RT,L35,1RT,5,3,2,2
L35 1RU,L35,1RU,100,47,53,44
L35 1RW,L35,1RW,85,42,43,37
L35 1SF,L35,1SF,144,65,79,44
L35 2UA,L35,2UA,91,48,43,33
L35 2UB,L35,2UB,24,11,13,12
L35 2UD,L35,2UD,36,19,17,14
L35 2UE,L35,2UE,52,28,24,26
L35 2UF,L35,2UF,26,11,15,10
L35 2UG,L35,2UG,51,23,28,23
L35 2UH,L35,2UH,41,15,26,17
L35 2UJ,L35,2UJ,114,55,59,53
L35 2UN,L35,2UN,43,20,23,17
L35 2UP,L35,2UP,27,11,16,11
L35 2UQ,L35,2UQ,46,26,20,19
L35 2UR,L35,2UR,31,15,16,10
L35 2US,L35,2US,57,28,29,24
L35 2UT,L35,2UT,39,18,21,14
L35 2UU,L35,2UU,22,6,16,10
L35 2UW,L35,2UW,71,39,32,35
L35 2UX,L35,2UX,23,11,12,8
L35 2UY,L35,2UY,34,12,22,15
L35 2UZ,L35,2UZ,75,36,39,28
L35 2XA,L35,2XA,98,44,54,36
L35 2XB,L35,2XB,41,20,21,17
L35 2XD,L35,2XD,116,54,62,43
L35 2XE,L35,2XE,46,20,26,20
L35 2XF,L35,2XF,101,41,60,41
L35 2XG,L35,2XG,27,12,15,11
L35 2XH,L35,2XH,121,59,62,44
L35 2XJ,L35,2XJ,69,34,35,25
L35 2XL,L35,2XL,20,10,10,7
L35 2XN,L35,2XN,39,20,19,12
L35 2XP,L35,2XP,44,22,22,20
L35 2XQ,L35,2XQ,49,24,25,20
L35 2XR,L35,2XR,66,34,32,24
L35 2XS,L35,2XS,54,26,28,24
L35 2XT,L35,2XT,50,25,25,26
L35 2XU,L35,2XU,48,21,27,26
L35 2XX,L35,2XX,106,52,54,44
L35 2XY,L35,2XY,50,23,27,22
L35 2XZ,L35,2XZ,38,15,23,14
L35 2YA,L35,2YA,53,24,29,24
L35 2YB,L35,2YB,39,18,21,23
L35 2YD,L35,2YD,22,9,13,12
L35 2YE,L35,2YE,35,18,17,18
L35 2YF,L35,2YF,61,26,35,22
L35 2YG,L35,2YG,27,12,15,12
L35 2YH,L35,2YH,14,7,7,10
L35 2YJ,L35,2YJ,34,15,19,12
L35 2YL,L35,2YL,15,3,12,12
L35 2YN,L35,2YN,78,44,34,31
L35 2YQ,L35,2YQ,34,15,19,12
L35 2YR,L35,2YR,10,8,2,10
L35 2YS,L35,2YS,38,19,19,16
L35 2YW,L35,2YW,68,28,40,33
L35 2YZ,L35,2YZ,6,4,2,1
L35 3BA,L35,3BA,7,6,1,6
L35 3JA,L35,3JA,50,26,24,15
L35 3JB,L35,3JB,71,32,39,55
L35 3JD,L35,3JD,35,19,16,14
L35 3JE,L35,3JE,116,52,64,47
L35 3JF,L35,3JF,122,57,65,45
L35 3JG,L35,3JG,77,32,45,29
L35 3JH,L35,3JH,129,60,69,45
L35 3JJ,L35,3JJ,151,74,77,53
L35 3JL,L35,3JL,92,43,49,39
L35 3JN,L35,3JN,49,20,29,19
L35 3JP,L35,3JP,70,40,30,29
L35 3JQ,L35,3JQ,133,68,65,42
L35 3JR,L35,3JR,47,21,26,18
L35 3JS,L35,3JS,76,36,40,29
L35 3JT,L35,3JT,41,21,20,16
L35 3JU,L35,3JU,35,19,16,11
L35 3JW,L35,3JW,98,48,50,37
L35 3JX,L35,3JX,28,19,9,25
L35 3JZ,L35,3JZ,130,59,71,45
L35 3PA,L35,3PA,71,33,38,30
L35 3PB,L35,3PB,39,13,26,15
L35 3PD,L35,3PD,76,42,34,32
L35 3PE,L35,3PE,89,41,48,33
L35 3PF,L35,3PF,51,22,29,18
L35 3PG,L35,3PG,49,23,26,18
L35 3PH,L35,3PH,41,17,24,16
L35 3PJ,L35,3PJ,24,10,14,10
L35 3PL,L35,3PL,83,38,45,32
L35 3PN,L35,3PN,44,23,21,21
L35 3PP,L35,3PP,32,13,19,12
L35 3PQ,L35,3PQ,84,40,44,32
L35 3PR,L35,3PR,40,19,21,15
L35 3PS,L35,3PS,33,19,14,17
L35 3PT,L35,3PT,19,9,10,9
L35 3PU,L35,3PU,51,27,24,31
L35 3PW,L35,3PW,31,19,12,14
L35 3PX,L35,3PX,37,20,17,24
L35 3PY,L35,3PY,26,12,14,15
L35 3PZ,L35,3PZ,3,1,2,2
L35 3QA,L35,3QA,18,10,8,14
L35 3QB,L35,3QB,15,7,8,9
L35 3QD,L35,3QD,8,4,4,3
L35 3QF,L35,3QF,13,8,5,4
L35 3QG,L35,3QG,48,27,21,21
L35 3QH,L35,3QH,48,24,24,21
L35 3QJ,L35,3QJ,80,42,38,31
L35 3QL,L35,3QL,53,30,23,21
L35 3QN,L35,3QN,23,11,12,11
L35 3QP,L35,3QP,24,11,13,6
L35 3QQ,L35,3QQ,50,28,22,22
L35 3QR,L35,3QR,106,46,60,44
L35 3QS,L35,3QS,61,24,37,30
L35 3QT,L35,3QT,9,5,4,5
L35 3QU,L35,3QU,53,23,30,24
L35 3QW,L35,3QW,46,23,23,18
L35 3QY,L35,3QY,54,22,32,38
L35 3QZ,L35,3QZ,16,5,11,8
L35 3RA,L35,3RA,20,9,11,12
L35 3RB,L35,3RB,63,29,34,24
L35 3RD,L35,3RD,75,32,43,29
L35 3RE,L35,3RE,53,24,29,23
L35 3RF,L35,3RF,2,1,1,2
L35 3RG,L35,3RG,36,14,22,16
L35 3RH,L35,3RH,47,21,26,15
L35 3RJ,L35,3RJ,5,3,2,3
L35 3RL,L35,3RL,12,7,5,7
L35 3RN,L35,3RN,65,27,38,25
L35 3RP,L35,3RP,34,19,15,15
L35 3RQ,L35,3RQ,45,23,22,22
L35 3RR,L35,3RR,32,20,12,10
L35 3RS,L35,3RS,13,7,6,6
L35 3RT,L35,3RT,10,4,6,5
L35 3RU,L35,3RU,149,73,76,62
L35 3RW,L35,3RW,58,29,29,25
L35 3RX,L35,3RX,35,19,16,13
L35 3RY,L35,3RY,22,11,11,12
L35 3RZ,L35,3RZ,70,35,35,28
L35 3SA,L35,3SA,73,34,39,33
L35 3SB,L35,3SB,43,22,21,24
L35 3SD,L35,3SD,109,51,58,46
L35 3SE,L35,3SE,19,11,8,9
L35 3SF,L35,3SF,72,39,33,30
L35 3SG,L35,3SG,44,25,19,20
L35 3SH,L35,3SH,70,29,41,31
L35 3SJ,L35,3SJ,52,27,25,21
L35 3SL,L35,3SL,107,55,52,48
L35 3SN,L35,3SN,48,21,27,19
L35 3SP,L35,3SP,79,43,36,31
L35 3SQ,L35,3SQ,56,24,32,27
L35 3SR,L35,3SR,6,3,3,2
L35 3SS,L35,3SS,13,6,7,5
L35 3ST,L35,3ST,3,2,1,2
L35 3SU,L35,3SU,10,5,5,6
L35 3SW,L35,3SW,54,22,32,26
L35 3SX,L35,3SX,5,4,1,2
L35 3SY,L35,3SY,42,22,20,21
L35 3SZ,L35,3SZ,25,11,14,11
L35 3TA,L35,3TA,97,51,46,38
L35 3TB,L35,3TB,106,49,57,51
L35 3TD,L35,3TD,141,73,68,49
L35 3TE,L35,3TE,74,41,33,31
L35 3TF,L35,3TF,84,41,43,41
L35 3TG,L35,3TG,82,39,43,35
L35 3TH,L35,3TH,108,57,51,47
L35 3TJ,L35,3TJ,8,4,4,3
L35 3TL,L35,3TL,12,7,5,8
L35 3TN,L35,3TN,60,30,30,25
L35 3TQ,L35,3TQ,62,30,32,28
L35 3TR,L35,3TR,37,23,14,21
L35 3TS,L35,3TS,45,22,23,14
L35 3TT,L35,3TT,32,12,20,18
L35 3TW,L35,3TW,60,30,30,40
L35 3TY,L35,3TY,135,59,76,53
L35 3TZ,L35,3TZ,14,7,7,5
L35 3UA,L35,3UA,29,15,14,13
L35 3UB,L35,3UB,23,12,11,10
L35 3UG,L35,3UG,117,59,58,34
L35 3UH,L35,3UH,97,40,57,35
L35 3UP,L35,3UP,84,44,40,25
L35 3UQ,L35,3UQ,97,48,49,42
L35 3US,L35,3US,14,6,8,5
L35 3UT,L35,3UT,69,33,36,28
L35 3UU,L35,3UU,61,35,26,25
L35 3UW,L35,3UW,38,14,24,16
L35 3UX,L35,3UX,42,19,23,13
L35 3UY,L35,3UY,43,18,25,15
L35 3UZ,L35,3UZ,66,30,36,27
L35 3XB,L35,3XB,130,66,64,52
L35 3XD,L35,3XD,65,31,34,20
L35 3XE,L35,3XE,47,23,24,15
L35 3XF,L35,3XF,40,19,21,12
L35 3XH,L35,3XH,31,18,13,11
L35 3XJ,L35,3XJ,32,13,19,15
L35 3XL,L35,3XL,12,6,6,7
L35 3XN,L35,3XN,96,46,50,36
L35 3XP,L35,3XP,26,14,12,12
L35 3XQ,L35,3XQ,15,9,6,5
L35 3XW,L35,3XW,107,54,53,36
L35 3XZ,L35,3XZ,8,4,4,4
L35 4LA,L35,4LA,22,12,10,11
L35 4LD,L35,4LD,87,46,41,38
L35 4LE,L35,4LE,11,5,6,5
L35 4LF,L35,4LF,20,8,12,7
L35 4LG,L35,4LG,40,20,20,16
L35 4LH,L35,4LH,41,18,23,17
L35 4LJ,L35,4LJ,82,40,42,33
L35 4LL,L35,4LL,32,14,18,25
L35 4LN,L35,4LN,31,16,15,12
L35 4LP,L35,4LP,23,15,8,11
L35 4LQ,L35,4LQ,43,17,26,17
L35 4LS,L35,4LS,68,33,35,37
L35 4LT,L35,4LT,63,27,36,25
L35 4LU,L35,4LU,7,7,0,7
L35 4LW,L35,4LW,78,38,40,31
L35 4LY,L35,4LY,38,14,24,6
L35 4LZ,L35,4LZ,12,9,3,5
L35 4ND,L35,4ND,5,3,2,2
L35 4NE,L35,4NE,22,9,13,11
L35 4NF,L35,4NF,41,18,23,21
L35 4NG,L35,4NG,19,10,9,12
L35 4NH,L35,4NH,5,2,3,2
L35 4NJ,L35,4NJ,38,17,21,17
L35 4NL,L35,4NL,35,17,18,18
L35 4NN,L35,4NN,61,36,25,25
L35 4NP,L35,4NP,63,29,34,27
L35 4NQ,L35,4NQ,85,43,42,39
L35 4NR,L35,4NR,38,18,20,18
L35 4NS,L35,4NS,22,10,12,10
L35 4NT,L35,4NT,83,39,44,34
L35 4NU,L35,4NU,11,7,4,4
L35 4NW,L35,4NW,73,37,36,32
L35 4NX,L35,4NX,32,15,17,17
L35 4NY,L35,4NY,87,43,44,33
L35 4NZ,L35,4NZ,89,46,43,33
L35 4PA,L35,4PA,63,34,29,24
L35 4PB,L35,4PB,15,6,9,8
L35 4PD,L35,4PD,46,23,23,9
L35 4PE,L35,4PE,7,5,2,3
L35 4PF,L35,4PF,21,11,10,10
L35 4PH,L35,4PH,52,26,26,18
L35 4PJ,L35,4PJ,57,33,24,20
L35 4PL,L35,4PL,19,8,11,9
L35 4PN,L35,4PN,74,33,41,20
L35 4PP,L35,4PP,83,46,37,34
L35 4PR,L35,4PR,67,30,37,31
L35 4PS,L35,4PS,25,12,13,8
L35 4PT,L35,4PT,8,3,5,3
L35 4PU,L35,4PU,60,30,30,20
L35 4PW,L35,4PW,32,18,14,16
L35 4PX,L35,4PX,96,44,52,39
L35 4PY,L35,4PY,50,20,30,26
L35 4PZ,L35,4PZ,139,67,72,52
L35 4QA,L35,4QA,25,11,14,9
L35 4QB,L35,4QB,42,20,22,15
L35 4QD,L35,4QD,67,33,34,27
L35 4QE,L35,4QE,62,33,29,27
L35 4QF,L35,4QF,70,35,35,29
L35 4QG,L35,4QG,7,3,4,4
L35 4QH,L35,4QH,119,61,58,48
L35 4QJ,L35,4QJ,82,36,46,27
L35 4QL,L35,4QL,55,30,25,21
L35 4QP,L35,4QP,40,14,26,37
L35 4QQ,L35,4QQ,69,38,31,28
L35 4QR,L35,4QR,46,20,26,19
L35 4QS,L35,4QS,43,20,23,18
L35 4QW,L35,4QW,36,19,17,13
L35 4QY,L35,4QY,45,20,25,20
L35 4QZ,L35,4QZ,70,35,35,24
L35 4RA,L35,4RA,35,17,18,9
L35 4RB,L35,4RB,7,2,5,5
L35 5AD,L35,5AD,65,40,25,26
L35 5AE,L35,5AE,38,23,15,23
L35 5AF,L35,5AF,44,20,24,21
L35 5AG,L35,5AG,99,44,55,43
L35 5AH,L35,5AH,33,14,19,14
L35 5AJ,L35,5AJ,75,25,50,36
L35 5AL,L35,5AL,4,1,3,2
L35 5AN,L35,5AN,33,15,18,14
L35 5AP,L35,5AP,121,62,59,59
L35 5AQ,L35,5AQ,38,20,18,15
L35 5AR,L35,5AR,109,56,53,36
L35 5AS,L35,5AS,85,43,42,31
L35 5AT,L35,5AT,107,53,54,48
L35 5AU,L35,5AU,29,16,13,13
L35 5AW,L35,5AW,79,43,36,27
L35 5AX,L35,5AX,76,38,38,30
L35 5AY,L35,5AY,72,37,35,27
L35 5AZ,L35,5AZ,39,19,20,16
L35 5BA,L35,5BA,43,21,22,16
L35 5BB,L35,5BB,46,23,23,12
L35 5BD,L35,5BD,90,41,49,38
L35 5BE,L35,5BE,71,37,34,28
L35 5BG,L35,5BG,83,40,43,32
L35 5BH,L35,5BH,120,44,76,50
L35 5BJ,L35,5BJ,108,49,59,39
L35 5BL,L35,5BL,83,36,47,24
L35 5BN,L35,5BN,37,17,20,16
L35 5BP,L35,5BP,78,33,45,27
L35 5BQ,L35,5BQ,44,23,21,15
L35 5BR,L35,5BR,60,28,32,19
L35 5BS,L35,5BS,105,55,50,34
L35 5BT,L35,5BT,12,5,7,5
L35 5BU,L35,5BU,84,36,48,35
L35 5BW,L35,5BW,70,25,45,29
L35 5BX,L35,5BX,21,10,11,7
L35 5BY,L35,5BY,63,26,37,25
L35 5BZ,L35,5BZ,57,23,34,13
L35 5DA,L35,5DA,52,19,33,20
L35 5DB,L35,5DB,59,31,28,21
L35 5DD,L35,5DD,52,26,26,20
L35 5DE,L35,5DE,73,34,39,30
L35 5DF,L35,5DF,39,20,19,31
L35 5DG,L35,5DG,82,36,46,34
L35 5DH,L35,5DH,35,18,17,16
L35 5DJ,L35,5DJ,47,25,22,17
L35 5DL,L35,5DL,45,20,25,22
L35 5DN,L35,5DN,27,14,13,11
L35 5DQ,L35,5DQ,27,12,15,9
L35 5DT,L35,5DT,66,30,36,30
L35 5DU,L35,5DU,45,24,21,16
L35 5DW,L35,5DW,64,34,30,27
L35 5DX,L35,5DX,27,12,15,9
L35 5DY,L35,5DY,53,25,28,20
L35 5DZ,L35,5DZ,28,14,14,10
L35 5EB,L35,5EB,60,23,37,23
L35 5ED,L35,5ED,49,23,26,15
L35 5EE,L35,5EE,39,21,18,23
L35 5EF,L35,5EF,43,26,17,23
L35 5EG,L35,5EG,57,30,27,24
L35 5EH,L35,5EH,35,18,17,23
L35 5EJ,L35,5EJ,61,34,27,29
L35 5EL,L35,5EL,30,13,17,17
L35 5EN,L35,5EN,75,38,37,24
L35 5EP,L35,5EP,74,35,39,36
L35 5EQ,L35,5EQ,43,19,24,18
L35 5ER,L35,5ER,94,46,48,32
L35 5ES,L35,5ES,102,49,53,41
L35 5ET,L35,5ET,46,22,24,18
L35 5EU,L35,5EU,66,28,38,24
L35 5EW,L35,5EW,60,30,30,21
L35 5EX,L35,5EX,115,52,63,42
L35 5EY,L35,5EY,74,33,41,31
L35 5EZ,L35,5EZ,83,39,44,29
L35 5GA,L35,5GA,19,9,10,6
L35 5HA,L35,5HA,34,19,15,13
L35 5HB,L35,5HB,58,30,28,23
L35 5HD,L35,5HD,69,30,39,26
L35 5HE,L35,5HE,86,41,45,38
L35 5HJ,L35,5HJ,90,45,45,29
L35 5HL,L35,5HL,71,33,38,26
L35 5HN,L35,5HN,18,9,9,8
L35 5HR,L35,5HR,33,17,16,12
L35 5HS,L35,5HS,17,8,9,5
L35 5HW,L35,5HW,41,24,17,18
L35 5JA,L35,5JA,124,52,72,57
L35 5JF,L35,5JF,5,3,2,4
L35 5JG,L35,5JG,3,3,0,3
L35 6DA,L35,6DA,34,17,17,11
L35 6DB,L35,6DB,8,5,3,4
L35 6DD,L35,6DD,79,39,40,24
L35 6DE,L35,6DE,36,17,19,10
L35 6DF,L35,6DF,51,26,25,18
L35 6NA,L35,6NA,30,18,12,8
L35 6NB,L35,6NB,32,14,18,6
L35 6NE,L35,6NE,24,10,14,8
L35 6NG,L35,6NG,31,15,16,13
L35 6NH,L35,6NH,44,23,21,22
L35 6NJ,L35,6NJ,2,1,1,1
L35 6NL,L35,6NL,8,4,4,4
L35 6NP,L35,6NP,5,2,3,2
L35 6NQ,L35,6NQ,27,14,13,11
L35 6NR,L35,6NR,38,16,22,17
L35 6NS,L35,6NS,22,11,11,11
L35 6NT,L35,6NT,8,4,4,3
L35 6NU,L35,6NU,4,2,2,1
L35 6NW,L35,6NW,3,2,1,2
L35 6NX,L35,6NX,18,9,9,7
L35 6NZ,L35,6NZ,15,7,8,0
L35 6PB,L35,6PB,10,4,6,3
L35 6PD,L35,6PD,230,123,107,87
L35 6PE,L35,6PE,47,23,24,18
L35 6PF,L35,6PF,6,3,3,2
L35 6PG,L35,6PG,29,14,15,13
L35 6PH,L35,6PH,43,23,20,17
L35 6PJ,L35,6PJ,53,25,28,29
L35 6PL,L35,6PL,45,22,23,20
L35 6PN,L35,6PN,33,16,17,13
L35 6PP,L35,6PP,47,21,26,38
L35 6PQ,L35,6PQ,21,9,12,10
L35 6PR,L35,6PR,18,8,10,11
L35 6PS,L35,6PS,9,5,4,4
L35 6PT,L35,6PT,32,14,18,12
L35 6PU,L35,6PU,27,13,14,9
L35 6PW,L35,6PW,106,53,53,43
L35 6PX,L35,6PX,36,19,17,12
L35 6PY,L35,6PY,86,45,41,30
L35 6PZ,L35,6PZ,48,24,24,16
L35 6QA,L35,6QA,41,21,20,13
L35 6QD,L35,6QD,31,16,15,10
L35 7JA,L35,7JA,42,20,22,25
L35 7JB,L35,7JB,14,4,10,6
L35 7JD,L35,7JD,11,5,6,4
L35 7JE,L35,7JE,33,18,15,16
L35 7JG,L35,7JG,4,2,2,2
L35 7JH,L35,7JH,23,12,11,9
L35 7JJ,L35,7JJ,2,1,1,1
L35 7JL,L35,7JL,40,20,20,13
L35 7JN,L35,7JN,60,31,29,22
L35 7JP,L35,7JP,10,3,7,7
L35 7JR,L35,7JR,9,6,3,3
L35 7JS,L35,7JS,1,1,0,1
L35 7JT,L35,7JT,82,37,45,40
L35 7JU,L35,7JU,18,9,9,9
L35 7JW,L35,7JW,46,21,25,22
L35 7JX,L35,7JX,36,23,13,18
L35 7JY,L35,7JY,59,28,31,20
L35 7JZ,L35,7JZ,58,31,27,20
L35 7LA,L35,7LA,15,8,7,7
L35 7LB,L35,7LB,12,8,4,6
L35 7LD,L35,7LD,59,26,33,24
L35 7LE,L35,7LE,42,15,27,20
L35 7LF,L35,7LF,76,36,40,28
L35 7LG,L35,7LG,45,22,23,23
L35 7LH,L35,7LH,56,26,30,29
L35 7LJ,L35,7LJ,44,24,20,22
L35 7LL,L35,7LL,65,35,30,28
L35 7LN,L35,7LN,57,34,23,23
L35 7LP,L35,7LP,29,16,13,27
L35 7LQ,L35,7LQ,66,29,37,31
L35 7LR,L35,7LR,15,4,11,5
L35 7LS,L35,7LS,198,107,91,49
L35 7LT,L35,7LT,30,18,12,11
L35 7LU,L35,7LU,33,18,15,12
L35 7LW,L35,7LW,50,21,29,24
L35 7LX,L35,7LX,41,21,20,12
L35 7LY,L35,7LY,43,21,22,12
L35 7LZ,L35,7LZ,30,15,15,10
L35 7NA,L35,7NA,34,18,16,12
L35 7NB,L35,7NB,73,35,38,23
L35 7ND,L35,7ND,24,11,13,10
L35 7NE,L35,7NE,31,13,18,11
L35 7NF,L35,7NF,65,34,31,25
L35 7NG,L35,7NG,54,27,27,18
L35 7NH,L35,7NH,98,44,54,37
L35 7NJ,L35,7NJ,137,69,68,46
L35 7NL,L35,7NL,71,30,41,22
L35 7NN,L35,7NN,68,34,34,24
L35 7NP,L35,7NP,15,9,6,5
L35 7NR,L35,7NR,24,10,14,8
L35 7NU,L35,7NU,42,18,24,18
L35 7NW,L35,7NW,76,38,38,21
L35 7NZ,L35,7NZ,89,45,44,29
L35 8LA,L35,8LA,12,7,5,5
L35 8LB,L35,8LB,42,20,22,21
L35 8LD,L35,8LD,23,12,11,10
L35 8LE,L35,8LE,75,36,39,36
L35 8LF,L35,8LF,29,12,17,12
L35 8LG,L35,8LG,40,19,21,16
L35 8LH,L35,8LH,34,21,13,13
L35 8LJ,L35,8LJ,82,43,39,37
L35 8LL,L35,8LL,71,33,38,33
L35 8LN,L35,8LN,80,38,42,34
L35 8LP,L35,8LP,62,32,30,23
L35 8LQ,L35,8LQ,55,29,26,23
L35 8LR,L35,8LR,67,35,32,27
L35 8LS,L35,8LS,51,29,22,20
L35 8LT,L35,8LT,55,25,30,26
L35 8LU,L35,8LU,58,31,27,24
L35 8LW,L35,8LW,43,18,25,21
L35 8LX,L35,8LX,49,23,26,20
L35 8LY,L35,8LY,23,12,11,13
L35 8LZ,L35,8LZ,70,39,31,23
L35 8NA,L35,8NA,81,36,45,38
L35 8NB,L35,8NB,102,43,59,29
L35 8NE,L35,8NE,53,23,30,23
L35 8NF,L35,8NF,60,34,26,31
L35 8NG,L35,8NG,56,30,26,24
L35 8NH,L35,8NH,66,35,31,33
L35 8NJ,L35,8NJ,2,1,1,2
L35 8NQ,L35,8NQ,71,29,42,34
L35 8NR,L35,8NR,2,1,1,1
L35 8NT,L35,8NT,85,44,41,34
L35 8NU,L35,8NU,60,27,33,31
L35 8NX,L35,8NX,75,42,33,32
L35 8NY,L35,8NY,20,10,10,11
L35 8NZ,L35,8NZ,5,3,2,3
L35 8PA,L35,8PA,52,25,27,24
L35 8PB,L35,8PB,17,9,8,7
L35 8PD,L35,8PD,34,16,18,15
L35 8PE,L35,8PE,69,35,34,27
L35 8PF,L35,8PF,42,19,23,16
L35 8PG,L35,8PG,49,23,26,19
L35 8PH,L35,8PH,82,42,40,34
L35 8PJ,L35,8PJ,31,16,15,14
L35 8PL,L35,8PL,64,31,33,27
L35 8PN,L35,8PN,47,22,25,20
L35 8PP,L35,8PP,62,33,29,26
L35 8PQ,L35,8PQ,55,27,28,21
L35 8PR,L35,8PR,51,28,23,22
L35 8PS,L35,8PS,3,2,1,2
L35 8PT,L35,8PT,50,21,29,21
L35 8PU,L35,8PU,46,25,21,22
L35 8PW,L35,8PW,55,28,27,23
L35 8PX,L35,8PX,5,2,3,2
L35 8PY,L35,8PY,75,41,34,34
L35 8PZ,L35,8PZ,12,7,5,6
L35 8QA,L35,8QA,53,26,27,19
L35 8QB,L35,8QB,40,23,17,14
L35 8QQ,L35,8QQ,16,10,6,9
L35 9JA,L35,9JA,38,19,19,14
L35 9JB,L35,9JB,25,12,13,12
L35 9JE,L35,9JE,40,19,21,15
L35 9JG,L35,9JG,65,30,35,26
L35 9JH,L35,9JH,70,38,32,31
L35 9JJ,L35,9JJ,51,28,23,21
L35 9JL,L35,9JL,43,20,23,17
L35 9JN,L35,9JN,12,3,9,6
L35 9JP,L35,9JP,34,18,16,11
L35 9JQ,L35,9JQ,104,50,54,42
L35 9JR,L35,9JR,39,19,20,15
L35 9JS,L35,9JS,82,41,41,36
L35 9JU,L35,9JU,51,25,26,21
L35 9JW,L35,9JW,39,20,19,16
L35 9JX,L35,9JX,4,3,1,2
L35 9JY,L35,9JY,68,37,31,27
L35 9JZ,L35,9JZ,31,5,26,0
L35 9LA,L35,9LA,16,5,11,8
L35 9LB,L35,9LB,21,8,13,14
L35 9LD,L35,9LD,44,19,25,17
L35 9LE,L35,9LE,25,14,11,11
L35 9LF,L35,9LF,50,24,26,16
L35 9LG,L35,9LG,59,27,32,27
L35 9LH,L35,9LH,86,45,41,34
L35 9LQ,L35,9LQ,41,18,23,14
L35 9LS,L35,9LS,11,6,5,5
L35 9LT,L35,9LT,74,39,35,27
L35 9LU,L35,9LU,34,18,16,10
L35 9LX,L35,9LX,84,40,44,27
L35 9LY,L35,9LY,26,13,13,9
L36 0RQ,L36,0RQ,33,15,18,21
L36 0SA,L36,0SA,49,20,29,17
L36 0SB,L36,0SB,35,18,17,14
L36 0SD,L36,0SD,92,42,50,52
L36 0SE,L36,0SE,39,22,17,18
L36 0SG,L36,0SG,71,37,34,32
L36 0SH,L36,0SH,37,20,17,12
L36 0SJ,L36,0SJ,54,25,29,38
L36 0SL,L36,0SL,37,17,20,14
L36 0SN,L36,0SN,87,41,46,37
L36 0SP,L36,0SP,75,28,47,35
L36 0SQ,L36,0SQ,47,26,21,18
L36 0SR,L36,0SR,74,36,38,36
L36 0SS,L36,0SS,64,28,36,28
L36 0ST,L36,0ST,48,24,24,20
L36 0SU,L36,0SU,29,13,16,13
L36 0SW,L36,0SW,110,51,59,44
L36 0SX,L36,0SX,66,32,34,27
L36 0SY,L36,0SY,49,22,27,19
L36 0SZ,L36,0SZ,70,29,41,30
L36 0TA,L36,0TA,41,21,20,15
L36 0TB,L36,0TB,20,10,10,14
L36 0TD,L36,0TD,39,17,22,14
L36 0TE,L36,0TE,40,17,23,12
L36 0TF,L36,0TF,65,26,39,21
L36 0TG,L36,0TG,72,36,36,34
L36 0TH,L36,0TH,68,32,36,34
L36 0TJ,L36,0TJ,70,33,37,31
L36 0TL,L36,0TL,112,53,59,51
L36 0TN,L36,0TN,33,18,15,14
L36 0TP,L36,0TP,87,40,47,36
L36 0TQ,L36,0TQ,39,19,20,26
L36 0TR,L36,0TR,65,25,40,28
L36 0TS,L36,0TS,54,22,32,24
L36 0TT,L36,0TT,62,31,31,27
L36 0TU,L36,0TU,44,18,26,22
L36 0TW,L36,0TW,63,35,28,25
L36 0TX,L36,0TX,60,23,37,24
L36 0TY,L36,0TY,94,51,43,33
L36 0TZ,L36,0TZ,71,33,38,27
L36 0UB,L36,0UB,20,12,8,10
L36 0UD,L36,0UD,8,3,5,4
L36 0UE,L36,0UE,16,8,8,8
L36 0UF,L36,0UF,8,4,4,5
L36 0UG,L36,0UG,30,12,18,16
L36 0UH,L36,0UH,72,30,42,28
L36 0UJ,L36,0UJ,118,56,62,44
L36 0UL,L36,0UL,17,6,11,10
L36 0UN,L36,0UN,50,21,29,21
L36 0UP,L36,0UP,30,15,15,11
L36 0UQ,L36,0UQ,28,12,16,10
L36 0UR,L36,0UR,84,46,38,34
L36 0US,L36,0US,28,12,16,10
L36 0UT,L36,0UT,28,11,17,11
L36 0UU,L36,0UU,44,20,24,19
L36 0UW,L36,0UW,52,26,26,22
L36 0UX,L36,0UX,7,1,6,3
L36 0UY,L36,0UY,55,26,29,24
L36 0UZ,L36,0UZ,25,12,13,13
L36 0XA,L36,0XA,55,22,33,36
L36 0XB,L36,0XB,53,21,32,25
L36 0XD,L36,0XD,56,25,31,29
L36 0XE,L36,0XE,36,17,19,22
L36 0XF,L36,0XF,21,11,10,6
L36 0XG,L36,0XG,35,15,20,12
L36 0XH,L36,0XH,25,13,12,10
L36 0XJ,L36,0XJ,44,22,22,19
L36 0XL,L36,0XL,41,22,19,14
L36 0XN,L36,0XN,23,12,11,9
L36 0XP,L36,0XP,5,2,3,4
L36 0XQ,L36,0XQ,6,2,4,4
L36 0XR,L36,0XR,43,17,26,16
L36 0XS,L36,0XS,41,17,24,15
L36 0XT,L36,0XT,20,13,7,8
L36 0XU,L36,0XU,29,12,17,9
L36 0XW,L36,0XW,44,23,21,19
L36 0XX,L36,0XX,30,16,14,9
L36 0XY,L36,0XY,65,33,32,21
L36 0XZ,L36,0XZ,12,5,7,5
L36 0YD,L36,0YD,42,18,24,10
L36 0YE,L36,0YE,10,6,4,3
L36 0YF,L36,0YF,84,41,43,29
L36 0YG,L36,0YG,106,56,50,34
L36 0YH,L36,0YH,62,29,33,19
L36 0YJ,L36,0YJ,69,35,34,26
L36 0YL,L36,0YL,60,25,35,20
L36 0YN,L36,0YN,84,41,43,28
L36 0YQ,L36,0YQ,9,5,4,5
L36 0YW,L36,0YW,18,8,10,16
L36 1SY,L36,1SY,30,6,24,14
L36 1TA,L36,1TA,94,47,47,38
L36 1TB,L36,1TB,40,17,23,15
L36 1TD,L36,1TD,35,20,15,16
L36 1TE,L36,1TE,92,54,38,41
L36 1TF,L36,1TF,45,16,29,20
L36 1TG,L36,1TG,22,9,13,6
L36 1TH,L36,1TH,26,11,15,9
L36 1TJ,L36,1TJ,111,54,57,39
L36 1TL,L36,1TL,90,42,48,31
L36 1TN,L36,1TN,52,26,26,24
L36 1TP,L36,1TP,46,19,27,16
L36 1TQ,L36,1TQ,103,48,55,39
L36 1TR,L36,1TR,59,26,33,29
L36 1TS,L36,1TS,55,26,29,23
L36 1TT,L36,1TT,78,35,43,31
L36 1TU,L36,1TU,71,31,40,29
L36 1TW,L36,1TW,95,46,49,33
L36 1TX,L36,1TX,58,28,30,25
L36 1TY,L36,1TY,52,29,23,20
L36 1TZ,L36,1TZ,75,39,36,28
L36 1UA,L36,1UA,44,26,18,18
L36 1UB,L36,1UB,24,14,10,10
L36 1UD,L36,1UD,39,18,21,21
L36 1UE,L36,1UE,16,5,11,5
L36 1UF,L36,1UF,23,11,12,10
L36 1UG,L36,1UG,23,12,11,22
L36 1UH,L36,1UH,27,8,19,10
L36 1UJ,L36,1UJ,21,10,11,16
L36 1UL,L36,1UL,14,9,5,7
L36 1UN,L36,1UN,51,21,30,22
L36 1UP,L36,1UP,51,30,21,21
L36 1UQ,L36,1UQ,21,10,11,12
L36 1UR,L36,1UR,12,5,7,8
L36 1US,L36,1US,13,5,8,8
L36 1UT,L36,1UT,16,10,6,9
L36 1UU,L36,1UU,64,44,20,44
L36 1UW,L36,1UW,33,14,19,13
L36 1UX,L36,1UX,37,15,22,15
L36 1UY,L36,1UY,31,21,10,26
L36 1UZ,L36,1UZ,18,8,10,10
L36 1XA,L36,1XA,47,23,24,22
L36 1XB,L36,1XB,39,18,21,12
L36 1XD,L36,1XD,15,5,10,9
L36 1XE,L36,1XE,49,29,20,38
L36 1XF,L36,1XF,49,26,23,18
L36 1XG,L36,1XG,18,8,10,9
L36 1XH,L36,1XH,31,11,20,15
L36 1XJ,L36,1XJ,50,20,30,20
L36 1XL,L36,1XL,27,14,13,12
L36 1XN,L36,1XN,65,32,33,28
L36 1XP,L36,1XP,38,15,23,19
L36 1XQ,L36,1XQ,43,22,21,17
L36 1XR,L36,1XR,19,11,8,10
L36 1XS,L36,1XS,16,7,9,7
L36 1XT,L36,1XT,26,11,15,9
L36 1XU,L36,1XU,23,12,11,13
L36 1XW,L36,1XW,96,44,52,37
L36 1XX,L36,1XX,58,25,33,21
L36 1XY,L36,1XY,31,11,20,25
L36 1YA,L36,1YA,12,6,6,5
L36 1YF,L36,1YF,33,18,15,15
L36 1YG,L36,1YG,34,14,20,14
L36 1YH,L36,1YH,49,17,32,18
L36 1YJ,L36,1YJ,40,15,25,16
L36 1YL,L36,1YL,22,11,11,15
L36 1YN,L36,1YN,9,4,5,4
L36 2AB,L36,2AB,73,28,45,25
L36 2JY,L36,2JY,73,29,44,27
L36 2LA,L36,2LA,64,29,35,27
L36 2LB,L36,2LB,44,20,24,18
L36 2LD,L36,2LD,36,19,17,16
L36 2LE,L36,2LE,43,23,20,19
L36 2LG,L36,2LG,33,18,15,11
L36 2LH,L36,2LH,38,16,22,16
L36 2LJ,L36,2LJ,35,15,20,15
L36 2LN,L36,2LN,82,36,46,34
L36 2LP,L36,2LP,5,3,2,4
L36 2LQ,L36,2LQ,52,22,30,21
L36 2LR,L36,2LR,72,35,37,26
L36 2LS,L36,2LS,62,34,28,22
L36 2LT,L36,2LT,74,33,41,33
L36 2LU,L36,2LU,85,35,50,37
L36 2LW,L36,2LW,99,40,59,37
L36 2LX,L36,2LX,53,25,28,25
L36 2LY,L36,2LY,21,10,11,8
L36 2LZ,L36,2LZ,67,35,32,24
L36 2NA,L36,2NA,29,15,14,10
L36 2NB,L36,2NB,17,7,10,15
L36 2ND,L36,2ND,65,33,32,26
L36 2NE,L36,2NE,139,66,73,54
L36 2NF,L36,2NF,130,63,67,54
L36 2NG,L36,2NG,65,29,36,30
L36 2NH,L36,2NH,91,41,50,44
L36 2NJ,L36,2NJ,27,11,16,11
L36 2NL,L36,2NL,5,3,2,3
L36 2NN,L36,2NN,41,20,21,19
L36 2NP,L36,2NP,39,17,22,17
L36 2NQ,L36,2NQ,77,30,47,36
L36 2NR,L36,2NR,38,17,21,18
L36 2NS,L36,2NS,46,24,22,21
L36 2NT,L36,2NT,69,32,37,26
L36 2NU,L36,2NU,42,20,22,18
L36 2NW,L36,2NW,102,50,52,39
L36 2NX,L36,2NX,18,7,11,8
L36 2NY,L36,2NY,50,18,32,21
L36 2NZ,L36,2NZ,54,17,37,23
L36 2PA,L36,2PA,20,11,9,11
L36 2PB,L36,2PB,7,3,4,4
L36 2PD,L36,2PD,12,5,7,5
L36 2PE,L36,2PE,84,45,39,33
L36 2PF,L36,2PF,80,38,42,34
L36 2PG,L36,2PG,83,44,39,35
L36 2PJ,L36,2PJ,89,37,52,38
L36 2PL,L36,2PL,86,47,39,34
L36 2PN,L36,2PN,59,27,32,24
L36 2PP,L36,2PP,79,42,37,28
L36 2PQ,L36,2PQ,60,22,38,23
L36 2PR,L36,2PR,68,36,32,25
L36 2PS,L36,2PS,120,58,62,49
L36 2PT,L36,2PT,51,27,24,20
L36 2PU,L36,2PU,61,26,35,26
L36 2PW,L36,2PW,9,4,5,4
L36 2PX,L36,2PX,56,24,32,24
L36 2PY,L36,2PY,102,41,61,39
L36 2PZ,L36,2PZ,77,39,38,27
L36 2QA,L36,2QA,11,9,2,9
L36 2QB,L36,2QB,5,3,2,3
L36 2QD,L36,2QD,138,62,76,54
L36 2QE,L36,2QE,85,37,48,32
L36 2QF,L36,2QF,29,14,15,13
L36 2QG,L36,2QG,133,62,71,52
L36 2QH,L36,2QH,73,32,41,28
L36 2QJ,L36,2QJ,99,52,47,37
L36 2QL,L36,2QL,87,46,41,34
L36 2QN,L36,2QN,62,36,26,29
L36 2QP,L36,2QP,74,37,37,28
L36 2QQ,L36,2QQ,49,26,23,19
L36 2QR,L36,2QR,44,19,25,19
L36 2QS,L36,2QS,49,16,33,20
L36 2QT,L36,2QT,154,74,80,62
L36 2QU,L36,2QU,26,11,15,12
L36 2QW,L36,2QW,103,49,54,40
L36 2QX,L36,2QX,45,20,25,39
L36 2QY,L36,2QY,35,12,23,23
L36 2QZ,L36,2QZ,1,0,1,1
L36 2RB,L36,2RB,23,10,13,17
L36 3RB,L36,3RB,46,27,19,20
L36 3RD,L36,3RD,61,25,36,22
L36 3RE,L36,3RE,38,17,21,19
L36 3RG,L36,3RG,25,12,13,8
L36 3RJ,L36,3RJ,68,35,33,32
L36 3RL,L36,3RL,69,25,44,30
L36 3RP,L36,3RP,79,33,46,32
L36 3RR,L36,3RR,88,42,46,36
L36 3RS,L36,3RS,50,30,20,18
L36 3RT,L36,3RT,35,15,20,14
L36 3RU,L36,3RU,18,6,12,9
L36 3RW,L36,3RW,5,2,3,2
L36 3RX,L36,3RX,52,21,31,22
L36 3RY,L36,3RY,72,33,39,26
L36 3RZ,L36,3RZ,84,44,40,31
L36 3SA,L36,3SA,34,16,18,15
L36 3SB,L36,3SB,62,29,33,26
L36 3SD,L36,3SD,26,14,12,11
L36 3SE,L36,3SE,53,22,31,21
L36 3SF,L36,3SF,54,24,30,24
L36 3SG,L36,3SG,92,40,52,35
L36 3SH,L36,3SH,99,49,50,44
L36 3SJ,L36,3SJ,106,46,60,40
L36 3SL,L36,3SL,66,33,33,27
L36 3SN,L36,3SN,86,34,52,35
L36 3SP,L36,3SP,125,58,67,42
L36 3SQ,L36,3SQ,58,25,33,25
L36 3SR,L36,3SR,91,43,48,40
L36 3SS,L36,3SS,38,31,7,34
L36 3ST,L36,3ST,33,33,0,30
L36 3SU,L36,3SU,50,32,18,34
L36 3SW,L36,3SW,75,30,45,28
L36 3SX,L36,3SX,40,26,14,29
L36 3TA,L36,3TA,101,41,60,46
L36 3TB,L36,3TB,106,51,55,43
L36 3TD,L36,3TD,61,22,39,24
L36 3TE,L36,3TE,67,33,34,26
L36 3TF,L36,3TF,55,21,34,24
L36 3TG,L36,3TG,74,32,42,25
L36 3TH,L36,3TH,38,22,16,15
L36 3TJ,L36,3TJ,29,16,13,13
L36 3TL,L36,3TL,59,30,29,27
L36 3TN,L36,3TN,47,20,27,19
L36 3TP,L36,3TP,16,9,7,8
L36 3TQ,L36,3TQ,80,35,45,26
L36 3TR,L36,3TR,86,36,50,34
L36 3TS,L36,3TS,14,7,7,3
L36 3TT,L36,3TT,100,49,51,36
L36 3TU,L36,3TU,72,31,41,33
L36 3TW,L36,3TW,15,10,5,6
L36 3TX,L36,3TX,126,53,73,41
L36 3UB,L36,3UB,41,19,22,14
L36 3UD,L36,3UD,62,26,36,29
L36 3UE,L36,3UE,83,35,48,30
L36 3UF,L36,3UF,23,8,15,12
L36 3UG,L36,3UG,39,18,21,14
L36 3UH,L36,3UH,103,55,48,38
L36 3UP,L36,3UP,87,42,45,35
L36 3UQ,L36,3UQ,45,21,24,17
L36 3UR,L36,3UR,93,40,53,34
L36 3US,L36,3US,98,49,49,40
L36 3UT,L36,3UT,84,43,41,42
L36 3UU,L36,3UU,31,12,19,15
L36 3UX,L36,3UX,16,7,9,11
L36 3UY,L36,3UY,101,47,54,42
L36 3UZ,L36,3UZ,49,21,28,23
L36 3WA,L36,3WA,6,3,3,4
L36 3WH,L36,3WH,29,16,13,22
L36 3XA,L36,3XA,110,50,60,49
L36 3XB,L36,3XB,90,43,47,45
L36 3XD,L36,3XD,45,22,23,18
L36 3XE,L36,3XE,123,52,71,51
L36 3XH,L36,3XH,50,25,25,22
L36 3XJ,L36,3XJ,27,9,18,10
L36 3XL,L36,3XL,97,49,48,41
L36 3XS,L36,3XS,29,21,8,25
L36 3XT,L36,3XT,16,7,9,14
L36 3XU,L36,3XU,20,12,8,15
L36 3XW,L36,3XW,37,20,17,16
L36 4HA,L36,4HA,15,7,8,8
L36 4HD,L36,4HD,3,1,2,1
L36 4HE,L36,4HE,24,13,11,7
L36 4HF,L36,4HF,53,29,24,23
L36 4HG,L36,4HG,37,16,21,16
L36 4HH,L36,4HH,16,8,8,6
L36 4HL,L36,4HL,83,41,42,29
L36 4HN,L36,4HN,67,31,36,25
L36 4HP,L36,4HP,21,11,10,8
L36 4HQ,L36,4HQ,30,13,17,13
L36 4HR,L36,4HR,17,9,8,10
L36 4HS,L36,4HS,19,9,10,14
L36 4HT,L36,4HT,5,2,3,2
L36 4HU,L36,4HU,43,17,26,19
L36 4HW,L36,4HW,81,37,44,32
L36 4HX,L36,4HX,14,3,11,5
L36 4HY,L36,4HY,11,5,6,5
L36 4HZ,L36,4HZ,38,18,20,17
L36 4JA,L36,4JA,30,11,19,13
L36 4JB,L36,4JB,64,36,28,23
L36 4JD,L36,4JD,73,34,39,32
L36 4JE,L36,4JE,84,42,42,36
L36 4JF,L36,4JF,82,37,45,30
L36 4JG,L36,4JG,66,32,34,27
L36 4JH,L36,4JH,68,33,35,28
L36 4JJ,L36,4JJ,92,42,50,30
L36 4JN,L36,4JN,91,47,44,32
L36 4JQ,L36,4JQ,94,47,47,42
L36 4JR,L36,4JR,94,46,48,34
L36 4JS,L36,4JS,100,51,49,40
L36 4JT,L36,4JT,124,63,61,42
L36 4JU,L36,4JU,101,48,53,35
L36 4JW,L36,4JW,87,44,43,33
L36 4JX,L36,4JX,101,47,54,38
L36 4JZ,L36,4JZ,98,48,50,40
L36 4LB,L36,4LB,57,26,31,24
L36 4LD,L36,4LD,124,63,61,50
L36 4LE,L36,4LE,61,27,34,25
L36 4LF,L36,4LF,27,17,10,8
L36 4LG,L36,4LG,79,36,43,43
L36 4LN,L36,4LN,101,51,50,44
L36 4LR,L36,4LR,93,36,57,46
L36 4LT,L36,4LT,63,32,31,28
L36 4LX,L36,4LX,43,21,22,25
L36 4LZ,L36,4LZ,70,37,33,30
L36 4NA,L36,4NA,55,18,37,43
L36 4NE,L36,4NE,134,69,65,52
L36 4NF,L36,4NF,23,9,14,9
L36 4NG,L36,4NG,51,23,28,18
L36 4NJ,L36,4NJ,68,35,33,31
L36 4NL,L36,4NL,83,41,42,32
L36 4NN,L36,4NN,72,35,37,26
L36 4NP,L36,4NP,53,24,29,21
L36 4NQ,L36,4NQ,85,36,49,50
L36 4NR,L36,4NR,43,21,22,20
L36 4NS,L36,4NS,130,65,65,53
L36 4NT,L36,4NT,133,57,76,49
L36 4NU,L36,4NU,129,60,69,52
L36 4NW,L36,4NW,14,6,8,5
L36 4NY,L36,4NY,64,33,31,28
L36 4NZ,L36,4NZ,65,30,35,33
L36 4PA,L36,4PA,19,8,11,7
L36 4PB,L36,4PB,118,51,67,48
L36 4PD,L36,4PD,122,54,68,49
L36 4PE,L36,4PE,6,2,4,4
L36 4PF,L36,4PF,100,43,57,42
L36 4PG,L36,4PG,71,32,39,28
L36 4PH,L36,4PH,90,41,49,34
L36 4PJ,L36,4PJ,69,24,45,14
L36 4PL,L36,4PL,45,23,22,36
L36 4PN,L36,4PN,51,27,24,18
L36 4PP,L36,4PP,61,32,29,26
L36 4PQ,L36,4PQ,70,37,33,25
L36 4PS,L36,4PS,12,4,8,7
L36 4PW,L36,4PW,3,2,1,2
L36 4PZ,L36,4PZ,118,66,52,42
L36 4QA,L36,4QA,74,40,34,28
L36 4QB,L36,4QB,34,16,18,14
L36 4QD,L36,4QD,62,33,29,26
L36 4QE,L36,4QE,23,11,12,13
L36 4QF,L36,4QF,48,22,26,17
L36 4QG,L36,4QG,84,42,42,31
L36 4QH,L36,4QH,22,11,11,7
L36 4QJ,L36,4QJ,26,14,12,10
L36 4QL,L36,4QL,57,29,28,24
L36 4QN,L36,4QN,46,23,23,18
L36 4QP,L36,4QP,62,31,31,19
L36 4QQ,L36,4QQ,27,13,14,11
L36 4QR,L36,4QR,47,22,25,14
L36 4QS,L36,4QS,37,9,28,30
L36 4QT,L36,4QT,67,32,35,25
L36 4QU,L36,4QU,29,15,14,9
L36 4QW,L36,4QW,20,10,10,8
L36 4QX,L36,4QX,114,57,57,41
L36 4QY,L36,4QY,49,25,24,20
L36 4QZ,L36,4QZ,24,11,13,11
L36 4RN,L36,4RN,28,13,15,10
L36 4RW,L36,4RW,17,11,6,5
L36 5PL,L36,5PL,3,1,2,2
L36 5RL,L36,5RL,36,17,19,11
L36 5RP,L36,5RP,35,15,20,12
L36 5RS,L36,5RS,11,4,7,4
L36 5RU,L36,5RU,58,27,31,23
L36 5RX,L36,5RX,44,23,21,18
L36 5RY,L36,5RY,39,18,21,14
L36 5RZ,L36,5RZ,16,4,12,0
L36 5SA,L36,5SA,48,22,26,17
L36 5SD,L36,5SD,27,15,12,9
L36 5SF,L36,5SF,47,25,22,15
L36 5SH,L36,5SH,29,11,18,14
L36 5SJ,L36,5SJ,24,11,13,12
L36 5SL,L36,5SL,4,1,3,2
L36 5SN,L36,5SN,58,29,29,27
L36 5SP,L36,5SP,87,41,46,38
L36 5SQ,L36,5SQ,10,5,5,5
L36 5SR,L36,5SR,20,8,12,9
L36 5SS,L36,5SS,60,35,25,19
L36 5ST,L36,5ST,64,32,32,27
L36 5SU,L36,5SU,78,39,39,32
L36 5SW,L36,5SW,13,5,8,6
L36 5SX,L36,5SX,41,21,20,17
L36 5TA,L36,5TA,34,14,20,17
L36 5TB,L36,5TB,15,9,6,7
L36 5TD,L36,5TD,51,26,25,20
L36 5TE,L36,5TE,30,17,13,11
L36 5TG,L36,5TG,42,21,21,18
L36 5TH,L36,5TH,51,23,28,20
L36 5TJ,L36,5TJ,23,11,12,9
L36 5TL,L36,5TL,21,9,12,8
L36 5TN,L36,5TN,28,14,14,18
L36 5TP,L36,5TP,74,33,41,27
L36 5TQ,L36,5TQ,25,13,12,11
L36 5TR,L36,5TR,54,26,28,23
L36 5TS,L36,5TS,67,26,41,35
L36 5TT,L36,5TT,98,46,52,39
L36 5TU,L36,5TU,99,48,51,38
L36 5TW,L36,5TW,47,23,24,19
L36 5TX,L36,5TX,27,13,14,11
L36 5TY,L36,5TY,73,28,45,29
L36 5TZ,L36,5TZ,52,21,31,20
L36 5UA,L36,5UA,51,25,26,18
L36 5UB,L36,5UB,38,17,21,20
L36 5UD,L36,5UD,70,33,37,32
L36 5UE,L36,5UE,54,27,27,20
L36 5UF,L36,5UF,43,23,20,16
L36 5UG,L36,5UG,27,12,15,16
L36 5UH,L36,5UH,82,40,42,33
L36 5UJ,L36,5UJ,49,24,25,23
L36 5UL,L36,5UL,24,12,12,12
L36 5UN,L36,5UN,69,29,40,29
L36 5UP,L36,5UP,22,11,11,10
L36 5UQ,L36,5UQ,63,30,33,27
L36 5UR,L36,5UR,26,13,13,10
L36 5US,L36,5US,14,9,5,6
L36 5UT,L36,5UT,18,8,10,7
L36 5UU,L36,5UU,4,2,2,1
L36 5UW,L36,5UW,53,21,32,24
L36 5UX,L36,5UX,25,9,16,11
L36 5UY,L36,5UY,53,15,38,2
L36 5UZ,L36,5UZ,63,32,31,22
L36 5XA,L36,5XA,11,6,5,5
L36 5XB,L36,5XB,83,43,40,32
L36 5XD,L36,5XD,9,5,4,3
L36 5XE,L36,5XE,44,22,22,18
L36 5XF,L36,5XF,44,25,19,16
L36 5XG,L36,5XG,62,20,42,4
L36 5XH,L36,5XH,41,19,22,20
L36 5XJ,L36,5XJ,36,17,19,13
L36 5XL,L36,5XL,64,33,31,27
L36 5XN,L36,5XN,51,30,21,22
L36 5XP,L36,5XP,50,27,23,21
L36 5XR,L36,5XR,31,17,14,12
L36 5XS,L36,5XS,43,22,21,15
L36 5XT,L36,5XT,55,29,26,23
L36 5XU,L36,5XU,40,16,24,22
L36 5XW,L36,5XW,49,10,39,2
L36 5XX,L36,5XX,46,24,22,19
L36 5XY,L36,5XY,48,23,25,22
L36 5XZ,L36,5XZ,69,34,35,24
L36 5YA,L36,5YA,67,34,33,28
L36 5YD,L36,5YD,41,21,20,17
L36 5YF,L36,5YF,54,22,32,22
L36 5YG,L36,5YG,26,13,13,11
L36 5YJ,L36,5YJ,51,20,31,21
L36 5YL,L36,5YL,9,4,5,3
L36 5YN,L36,5YN,89,43,46,29
L36 5YQ,L36,5YQ,117,51,66,47
L36 5YR,L36,5YR,116,51,65,45
L36 5YS,L36,5YS,54,25,29,20
L36 5YW,L36,5YW,9,4,5,6
L36 5YX,L36,5YX,83,36,47,42
L36 5YY,L36,5YY,66,33,33,26
L36 6AD,L36,6AD,10,6,4,4
L36 6AG,L36,6AG,7,4,3,3
L36 6AQ,L36,6AQ,9,3,6,4
L36 6AR,L36,6AR,10,3,7,6
L36 6AT,L36,6AT,16,7,9,6
L36 6AX,L36,6AX,6,1,5,5
L36 6AY,L36,6AY,1,0,1,1
L36 6AZ,L36,6AZ,14,6,8,8
L36 6BA,L36,6BA,1,0,1,1
L36 6BB,L36,6BB,26,14,12,10
L36 6BG,L36,6BG,118,47,71,47
L36 6BH,L36,6BH,9,4,5,3
L36 6BQ,L36,6BQ,73,39,34,31
L36 6BR,L36,6BR,13,8,5,5
L36 6BS,L36,6BS,23,7,16,10
L36 6BT,L36,6BT,121,58,63,44
L36 6BU,L36,6BU,37,17,20,17
L36 6BX,L36,6BX,53,30,23,21
L36 6BY,L36,6BY,37,19,18,17
L36 6BZ,L36,6BZ,105,49,56,45
L36 6DA,L36,6DA,52,27,25,21
L36 6DB,L36,6DB,12,8,4,4
L36 6DD,L36,6DD,50,19,31,19
L36 6DE,L36,6DE,34,17,17,16
L36 6DF,L36,6DF,16,6,10,10
L36 6DH,L36,6DH,40,19,21,16
L36 6DJ,L36,6DJ,38,20,18,14
L36 6DL,L36,6DL,82,40,42,30
L36 6DN,L36,6DN,78,33,45,40
L36 6DP,L36,6DP,35,15,20,21
L36 6DQ,L36,6DQ,21,10,11,15
L36 6DR,L36,6DR,65,26,39,28
L36 6DS,L36,6DS,49,17,32,14
L36 6DT,L36,6DT,63,31,32,25
L36 6DU,L36,6DU,13,8,5,6
L36 6DW,L36,6DW,111,48,63,50
L36 6DX,L36,6DX,53,25,28,23
L36 6DY,L36,6DY,10,5,5,5
L36 6DZ,L36,6DZ,15,5,10,7
L36 6EA,L36,6EA,45,26,19,18
L36 6EB,L36,6EB,38,26,12,27
L36 6ED,L36,6ED,29,14,15,7
L36 6EE,L36,6EE,9,5,4,4
L36 6EF,L36,6EF,72,32,40,27
L36 6EG,L36,6EG,17,8,9,6
L36 6EH,L36,6EH,59,28,31,24
L36 6EJ,L36,6EJ,6,2,4,2
L36 6EL,L36,6EL,15,8,7,4
L36 6EN,L36,6EN,12,6,6,4
L36 6EP,L36,6EP,43,23,20,17
L36 6EQ,L36,6EQ,37,14,23,14
L36 6ER,L36,6ER,19,8,11,6
L36 6ET,L36,6ET,72,38,34,26
L36 6EU,L36,6EU,8,5,3,6
L36 6EX,L36,6EX,19,7,12,8
L36 6EZ,L36,6EZ,22,12,10,8
L36 6FB,L36,6FB,23,8,15,16
L36 6HA,L36,6HA,55,27,28,20
L36 6HB,L36,6HB,43,19,24,18
L36 6HD,L36,6HD,39,18,21,17
L36 6HE,L36,6HE,69,34,35,27
L36 6HL,L36,6HL,11,4,7,5
L36 6HN,L36,6HN,72,38,34,42
L36 6HP,L36,6HP,6,1,5,3
L36 6HR,L36,6HR,51,28,23,36
L36 6HS,L36,6HS,65,31,34,32
L36 6HW,L36,6HW,7,4,3,4
L36 6LF,L36,6LF,28,12,16,10
L36 6LH,L36,6LH,3,1,2,1
L36 6LP,L36,6LP,39,28,11,31
L36 6LS,L36,6LS,36,13,23,14
L36 6LT,L36,6LT,33,14,19,17
L36 6LX,L36,6LX,45,21,24,17
L36 7RJ,L36,7RJ,11,7,4,6
L36 7RN,L36,7RN,35,19,16,10
L36 7RP,L36,7RP,35,14,21,14
L36 7RQ,L36,7RQ,10,6,4,4
L36 7RR,L36,7RR,7,3,4,2
L36 7RS,L36,7RS,18,8,10,8
L36 7RU,L36,7RU,10,6,4,9
L36 7RW,L36,7RW,10,4,6,4
L36 7RX,L36,7RX,11,4,7,9
L36 7RY,L36,7RY,9,3,6,8
L36 7SA,L36,7SA,67,26,41,28
L36 7SB,L36,7SB,19,7,12,10
L36 7SD,L36,7SD,67,25,42,28
L36 7SE,L36,7SE,84,45,39,29
L36 7SF,L36,7SF,91,45,46,34
L36 7SG,L36,7SG,77,30,47,34
L36 7SH,L36,7SH,42,23,19,19
L36 7SJ,L36,7SJ,31,14,17,16
L36 7SL,L36,7SL,3,2,1,3
L36 7SN,L36,7SN,37,21,16,15
L36 7SP,L36,7SP,97,45,52,35
L36 7SQ,L36,7SQ,98,51,47,33
L36 7SR,L36,7SR,63,30,33,28
L36 7SS,L36,7SS,54,26,28,17
L36 7ST,L36,7ST,61,27,34,24
L36 7SU,L36,7SU,42,15,27,14
L36 7SW,L36,7SW,62,25,37,30
L36 7SX,L36,7SX,34,17,17,16
L36 7SY,L36,7SY,8,4,4,2
L36 7SZ,L36,7SZ,94,44,50,38
L36 7TA,L36,7TA,13,8,5,5
L36 7TB,L36,7TB,60,28,32,26
L36 7TD,L36,7TD,40,21,19,13
L36 7TE,L36,7TE,54,23,31,22
L36 7TF,L36,7TF,43,19,24,13
L36 7TG,L36,7TG,56,23,33,23
L36 7TH,L36,7TH,100,49,51,37
L36 7TJ,L36,7TJ,84,34,50,24
L36 7TL,L36,7TL,74,32,42,39
L36 7TN,L36,7TN,40,17,23,16
L36 7TP,L36,7TP,41,19,22,19
L36 7TQ,L36,7TQ,67,37,30,24
L36 7TR,L36,7TR,17,9,8,10
L36 7TS,L36,7TS,9,3,6,7
L36 7TT,L36,7TT,28,12,16,9
L36 7TU,L36,7TU,7,4,3,7
L36 7TW,L36,7TW,5,2,3,4
L36 7TY,L36,7TY,36,18,18,21
L36 7TZ,L36,7TZ,29,12,17,12
L36 7UA,L36,7UA,24,13,11,10
L36 7UB,L36,7UB,16,7,9,8
L36 7UD,L36,7UD,18,10,8,9
L36 7UE,L36,7UE,29,13,16,11
L36 7UF,L36,7UF,61,24,37,25
L36 7UG,L36,7UG,64,31,33,31
L36 7UH,L36,7UH,41,21,20,18
L36 7UJ,L36,7UJ,47,19,28,23
L36 7UL,L36,7UL,30,12,18,11
L36 7UN,L36,7UN,53,30,23,19
L36 7UP,L36,7UP,75,34,41,31
L36 7UQ,L36,7UQ,55,29,26,21
L36 7UR,L36,7UR,39,20,19,20
L36 7US,L36,7US,12,3,9,5
L36 7UT,L36,7UT,24,12,12,10
L36 7UU,L36,7UU,52,27,25,23
L36 7UW,L36,7UW,11,5,6,3
L36 7UX,L36,7UX,68,30,38,32
L36 7UY,L36,7UY,26,16,10,19
L36 7UZ,L36,7UZ,35,19,16,22
L36 7XA,L36,7XA,96,48,48,56
L36 7XB,L36,7XB,19,8,11,12
L36 7XD,L36,7XD,20,8,12,13
L36 7XE,L36,7XE,2,1,1,1
L36 7XF,L36,7XF,45,22,23,14
L36 7XG,L36,7XG,23,4,19,2
L36 7XH,L36,7XH,9,4,5,3
L36 7XJ,L36,7XJ,39,22,17,16
L36 7XL,L36,7XL,4,2,2,2
L36 7XN,L36,7XN,13,5,8,3
L36 7XP,L36,7XP,67,26,41,27
L36 7XQ,L36,7XQ,23,10,13,14
L36 7XR,L36,7XR,1,1,0,1
L36 7XS,L36,7XS,18,10,8,7
L36 7XT,L36,7XT,33,20,13,15
L36 7XU,L36,7XU,77,37,40,29
L36 7XW,L36,7XW,75,37,38,30
L36 7XX,L36,7XX,39,17,22,17
L36 7XY,L36,7XY,37,21,16,20
L36 7XZ,L36,7XZ,64,26,38,17
L36 7YA,L36,7YA,32,11,21,16
L36 7YH,L36,7YH,19,8,11,8
L36 7YJ,L36,7YJ,32,14,18,19
L36 7YL,L36,7YL,25,16,9,20
L36 7YP,L36,7YP,64,32,32,48
L36 7YR,L36,7YR,49,20,29,24
L36 7YT,L36,7YT,14,11,3,4
L36 7YU,L36,7YU,50,18,32,40
L36 7YZ,L36,7YZ,73,36,37,30
L36 8AT,L36,8AT,11,6,5,8
L36 8AU,L36,8AU,8,5,3,6
L36 8AW,L36,8AW,24,13,11,13
L36 8AX,L36,8AX,6,3,3,4
L36 8AY,L36,8AY,4,4,0,4
L36 8BA,L36,8BA,74,37,37,31
L36 8BB,L36,8BB,22,9,13,10
L36 8BD,L36,8BD,111,57,54,43
L36 8BE,L36,8BE,28,13,15,12
L36 8BG,L36,8BG,39,15,24,16
L36 8BH,L36,8BH,82,33,49,24
L36 8BJ,L36,8BJ,2,2,0,2
L36 8BL,L36,8BL,21,10,11,6
L36 8BN,L36,8BN,56,27,29,21
L36 8BP,L36,8BP,25,10,15,12
L36 8BQ,L36,8BQ,95,44,51,30
L36 8BR,L36,8BR,24,8,16,11
L36 8BS,L36,8BS,50,23,27,20
L36 8BT,L36,8BT,49,25,24,34
L36 8BU,L36,8BU,42,20,22,16
L36 8BW,L36,8BW,55,26,29,21
L36 8BX,L36,8BX,36,17,19,16
L36 8BY,L36,8BY,86,44,42,39
L36 8BZ,L36,8BZ,91,41,50,41
L36 8DA,L36,8DA,23,8,15,10
L36 8DD,L36,8DD,76,33,43,36
L36 8DE,L36,8DE,62,22,40,31
L36 8DF,L36,8DF,53,22,31,21
L36 8DG,L36,8DG,98,46,52,38
L36 8DH,L36,8DH,48,22,26,22
L36 8DJ,L36,8DJ,51,23,28,25
L36 8DL,L36,8DL,36,15,21,18
L36 8DP,L36,8DP,24,12,12,11
L36 8DQ,L36,8DQ,65,30,35,28
L36 8DR,L36,8DR,73,34,39,27
L36 8DS,L36,8DS,38,20,18,13
L36 8DU,L36,8DU,12,4,8,6
L36 8DW,L36,8DW,71,34,37,23
L36 8DX,L36,8DX,103,46,57,13
L36 8EH,L36,8EH,30,14,16,12
L36 8EJ,L36,8EJ,19,7,12,6
L36 8EL,L36,8EL,119,51,68,32
L36 8EP,L36,8EP,32,17,15,21
L36 8ER,L36,8ER,16,7,9,8
L36 8ES,L36,8ES,90,45,45,37
L36 8ET,L36,8ET,103,44,59,41
L36 8EU,L36,8EU,86,39,47,30
L36 8EX,L36,8EX,37,19,18,14
L36 8EY,L36,8EY,36,18,18,15
L36 8EZ,L36,8EZ,24,8,16,7
L36 8FB,L36,8FB,9,6,3,3
L36 8FD,L36,8FD,66,32,34,19
L36 8FE,L36,8FE,40,18,22,14
L36 8FF,L36,8FF,48,24,24,17
L36 8FG,L36,8FG,109,55,54,46
L36 8FH,L36,8FH,44,18,26,17
L36 8FN,L36,8FN,96,52,44,45
L36 8HA,L36,8HA,91,39,52,35
L36 8HB,L36,8HB,98,39,59,35
L36 8HD,L36,8HD,66,39,27,25
L36 8HE,L36,8HE,17,8,9,7
L36 8HF,L36,8HF,53,19,34,24
L36 8HG,L36,8HG,92,38,54,36
L36 8HH,L36,8HH,50,28,22,20
L36 8HJ,L36,8HJ,61,31,30,27
L36 8HL,L36,8HL,30,16,14,14
L36 8HN,L36,8HN,76,35,41,32
L36 8HP,L36,8HP,71,37,34,43
L36 8HQ,L36,8HQ,92,30,62,39
L36 8HR,L36,8HR,84,42,42,31
L36 8HS,L36,8HS,6,3,3,3
L36 8HT,L36,8HT,75,40,35,30
L36 8HU,L36,8HU,6,4,2,4
L36 8HW,L36,8HW,68,33,35,33
L36 8HX,L36,8HX,7,3,4,3
L36 8JB,L36,8JB,60,37,23,25
L36 8JD,L36,8JD,161,69,92,59
L36 8JE,L36,8JE,48,16,32,17
L36 8JF,L36,8JF,119,61,58,39
L36 8JG,L36,8JG,60,34,26,21
L36 8JH,L36,8JH,34,19,15,12
L36 8JJ,L36,8JJ,90,47,43,32
L36 8JL,L36,8JL,62,28,34,18
L36 8JN,L36,8JN,33,18,15,13
L36 8JQ,L36,8JQ,45,25,20,14
L36 8JW,L36,8JW,69,27,42,25
L36 9BB,L36,9BB,29,15,14,16
L36 9GE,L36,9GE,42,10,32,35
L36 9TA,L36,9TA,51,23,28,22
L36 9TB,L36,9TB,40,12,28,15
L36 9TD,L36,9TD,41,23,18,14
L36 9TE,L36,9TE,18,11,7,7
L36 9TF,L36,9TF,4,2,2,2
L36 9TG,L36,9TG,83,41,42,35
L36 9TH,L36,9TH,26,15,11,13
L36 9TJ,L36,9TJ,29,14,15,18
L36 9TL,L36,9TL,43,20,23,15
L36 9TN,L36,9TN,39,20,19,18
L36 9TP,L36,9TP,56,22,34,12
L36 9TQ,L36,9TQ,36,17,19,14
L36 9TR,L36,9TR,48,28,20,23
L36 9TS,L36,9TS,67,34,33,27
L36 9TT,L36,9TT,62,31,31,29
L36 9TU,L36,9TU,23,9,14,15
L36 9TW,L36,9TW,22,8,14,11
L36 9TX,L36,9TX,14,5,9,6
L36 9TY,L36,9TY,61,28,33,25
L36 9TZ,L36,9TZ,77,30,47,28
L36 9UA,L36,9UA,78,39,39,31
L36 9UB,L36,9UB,74,34,40,30
L36 9UD,L36,9UD,154,71,83,64
L36 9UE,L36,9UE,54,26,28,20
L36 9UF,L36,9UF,50,24,26,20
L36 9UQ,L36,9UQ,9,5,4,2
L36 9XA,L36,9XA,7,4,3,5
L36 9XB,L36,9XB,23,11,12,9
L36 9XD,L36,9XD,9,5,4,6
L36 9XE,L36,9XE,41,18,23,21
L36 9XF,L36,9XF,5,2,3,4
L36 9XG,L36,9XG,53,28,25,18
L36 9XH,L36,9XH,33,19,14,14
L36 9XJ,L36,9XJ,13,8,5,5
L36 9XL,L36,9XL,35,18,17,16
L36 9XN,L36,9XN,17,8,9,8
L36 9XQ,L36,9XQ,68,32,36,25
L36 9XR,L36,9XR,19,11,8,6
L36 9XW,L36,9XW,72,31,41,24
L37 0AB,L37,0AB,19,7,12,6
L37 0AE,L37,0AE,30,15,15,12
L37 0AF,L37,0AF,32,14,18,14
L37 0AH,L37,0AH,49,20,29,13
L37 0AL,L37,0AL,4,2,2,2
L37 0AN,L37,0AN,10,3,7,4
L37 0AP,L37,0AP,14,6,8,5
L37 0AQ,L37,0AQ,7,3,4,2
L37 0AW,L37,0AW,14,9,5,5
L37 1LA,L37,1LA,47,23,24,16
L37 1LB,L37,1LB,6,3,3,2
L37 1LD,L37,1LD,12,6,6,4
L37 1LE,L37,1LE,14,9,5,6
L37 1LF,L37,1LF,14,6,8,8
L37 1LH,L37,1LH,56,31,25,9
L37 1LJ,L37,1LJ,28,13,15,11
L37 1LL,L37,1LL,13,5,8,6
L37 1LN,L37,1LN,29,15,14,10
L37 1LP,L37,1LP,48,19,29,16
L37 1LR,L37,1LR,39,16,23,17
L37 1LS,L37,1LS,23,10,13,7
L37 1LT,L37,1LT,24,13,11,12
L37 1LU,L37,1LU,81,38,43,34
L37 1LW,L37,1LW,28,26,2,0
L37 1LX,L37,1LX,28,14,14,10
L37 1LY,L37,1LY,24,12,12,15
L37 1LZ,L37,1LZ,29,13,16,12
L37 1NA,L37,1NA,15,7,8,7
L37 1NB,L37,1NB,31,12,19,13
L37 1ND,L37,1ND,9,4,5,5
L37 1NE,L37,1NE,36,14,22,19
L37 1NF,L37,1NF,39,19,20,19
L37 1NG,L37,1NG,39,17,22,14
L37 1NH,L37,1NH,78,40,38,29
L37 1NJ,L37,1NJ,19,10,9,9
L37 1NL,L37,1NL,22,9,13,12
L37 1NN,L37,1NN,11,3,8,7
L37 1NP,L37,1NP,11,5,6,3
L37 1NQ,L37,1NQ,34,17,17,19
L37 1NR,L37,1NR,36,18,18,14
L37 1NS,L37,1NS,19,10,9,7
L37 1NT,L37,1NT,42,23,19,20
L37 1NU,L37,1NU,53,24,29,23
L37 1NW,L37,1NW,36,14,22,21
L37 1NX,L37,1NX,47,22,25,21
L37 1NY,L37,1NY,40,18,22,16
L37 1NZ,L37,1NZ,49,21,28,19
L37 1PA,L37,1PA,33,20,13,14
L37 1PB,L37,1PB,36,16,20,16
L37 1PD,L37,1PD,85,37,48,39
L37 1PE,L37,1PE,29,11,18,11
L37 1PF,L37,1PF,33,14,19,18
L37 1PG,L37,1PG,49,26,23,19
L37 1PH,L37,1PH,48,16,32,2
L37 1PL,L37,1PL,31,18,13,13
L37 1PN,L37,1PN,89,47,42,33
L37 1PP,L37,1PP,72,33,39,29
L37 1PQ,L37,1PQ,48,22,26,19
L37 1PR,L37,1PR,33,18,15,12
L37 1PS,L37,1PS,9,5,4,4
L37 1PT,L37,1PT,53,23,30,29
L37 1PU,L37,1PU,18,7,11,9
L37 1PW,L37,1PW,73,36,37,30
L37 1PX,L37,1PX,93,51,42,35
L37 1PY,L37,1PY,49,24,25,19
L37 1PZ,L37,1PZ,56,34,22,26
L37 1QA,L37,1QA,4,2,2,2
L37 1XN,L37,1XN,67,32,35,30
L37 1XP,L37,1XP,29,16,13,12
L37 1XR,L37,1XR,78,34,44,38
L37 1XS,L37,1XS,25,12,13,10
L37 1XT,L37,1XT,64,32,32,28
L37 1XU,L37,1XU,14,7,7,7
L37 1XW,L37,1XW,45,18,27,20
L37 1XX,L37,1XX,9,5,4,5
L37 1XY,L37,1XY,24,12,12,9
L37 1XZ,L37,1XZ,25,11,14,10
L37 1YB,L37,1YB,2,1,1,1
L37 1YD,L37,1YD,1,0,1,1
L37 1YF,L37,1YF,16,9,7,6
L37 1YH,L37,1YH,11,3,8,4
L37 1YX,L37,1YX,8,6,2,2
L37 2DA,L37,2DA,39,20,19,18
L37 2DB,L37,2DB,18,8,10,7
L37 2DD,L37,2DD,2,1,1,2
L37 2DF,L37,2DF,15,9,6,4
L37 2DG,L37,2DG,52,27,25,20
L37 2DH,L37,2DH,40,16,24,16
L37 2DJ,L37,2DJ,53,26,27,21
L37 2DL,L37,2DL,52,26,26,23
L37 2DN,L37,2DN,58,31,27,21
L37 2DP,L37,2DP,27,12,15,11
L37 2DQ,L37,2DQ,29,14,15,13
L37 2DR,L37,2DR,23,11,12,8
L37 2DS,L37,2DS,21,6,15,8
L37 2DT,L37,2DT,22,12,10,8
L37 2DU,L37,2DU,19,10,9,11
L37 2DW,L37,2DW,54,22,32,20
L37 2DX,L37,2DX,34,15,19,15
L37 2DY,L37,2DY,23,13,10,11
L37 2DZ,L37,2DZ,70,35,35,27
L37 2EA,L37,2EA,198,96,102,74
L37 2ED,L37,2ED,19,10,9,5
L37 2EE,L37,2EE,34,17,17,16
L37 2EF,L37,2EF,48,24,24,22
L37 2EG,L37,2EG,94,42,52,23
L37 2EH,L37,2EH,1,1,0,1
L37 2EJ,L37,2EJ,14,7,7,5
L37 2EL,L37,2EL,66,33,33,26
L37 2EN,L37,2EN,37,16,21,16
L37 2EP,L37,2EP,31,15,16,12
L37 2EQ,L37,2EQ,46,24,22,17
L37 2ER,L37,2ER,21,11,10,8
L37 2ES,L37,2ES,7,2,5,4
L37 2ET,L37,2ET,63,33,30,27
L37 2EU,L37,2EU,87,35,52,21
L37 2EW,L37,2EW,44,16,28,10
L37 2EX,L37,2EX,86,37,49,26
L37 2EY,L37,2EY,69,34,35,27
L37 2EZ,L37,2EZ,7,3,4,3
L37 2FF,L37,2FF,20,7,13,11
L37 2FN,L37,2FN,88,44,44,35
L37 2FP,L37,2FP,12,5,7,5
L37 2FS,L37,2FS,12,4,8,7
L37 2FW,L37,2FW,6,2,4,4
L37 2HA,L37,2HA,9,4,5,4
L37 2HB,L37,2HB,51,25,26,18
L37 2HD,L37,2HD,38,22,16,14
L37 2HE,L37,2HE,19,6,13,8
L37 2HF,L37,2HF,33,14,19,14
L37 2HG,L37,2HG,35,17,18,14
L37 2HH,L37,2HH,49,23,26,18
L37 2HJ,L37,2HJ,18,8,10,6
L37 2HL,L37,2HL,27,14,13,10
L37 2HN,L37,2HN,32,15,17,13
L37 2HP,L37,2HP,58,34,24,20
L37 2HQ,L37,2HQ,16,8,8,5
L37 2HR,L37,2HR,24,13,11,10
L37 2HS,L37,2HS,27,12,15,9
L37 2HT,L37,2HT,42,22,20,15
L37 2HU,L37,2HU,1,1,0,1
L37 2HW,L37,2HW,29,11,18,10
L37 2HX,L37,2HX,27,14,13,16
L37 2HY,L37,2HY,62,30,32,25
L37 2HZ,L37,2HZ,50,23,27,23
L37 2JA,L37,2JA,43,21,22,21
L37 2JB,L37,2JB,26,10,16,14
L37 2JD,L37,2JD,70,32,38,27
L37 2JE,L37,2JE,20,9,11,11
L37 2JG,L37,2JG,41,21,20,17
L37 2JH,L37,2JH,39,16,23,31
L37 2JJ,L37,2JJ,18,7,11,15
L37 2JL,L37,2JL,64,28,36,26
L37 2JN,L37,2JN,54,27,27,21
L37 2JP,L37,2JP,4,3,1,2
L37 2JQ,L37,2JQ,35,18,17,14
L37 2JR,L37,2JR,13,6,7,8
L37 2JS,L37,2JS,23,13,10,8
L37 2JT,L37,2JT,32,16,16,15
L37 2JU,L37,2JU,34,21,13,12
L37 2JW,L37,2JW,58,28,30,21
L37 2JX,L37,2JX,34,14,20,16
L37 2JY,L37,2JY,43,25,18,15
L37 2JZ,L37,2JZ,32,13,19,12
L37 2LA,L37,2LA,17,8,9,5
L37 2LB,L37,2LB,52,28,24,21
L37 2LD,L37,2LD,45,22,23,20
L37 2LE,L37,2LE,98,48,50,37
L37 2LF,L37,2LF,21,10,11,9
L37 2LG,L37,2LG,24,10,14,12
L37 2LH,L37,2LH,143,69,74,53
L37 2LJ,L37,2LJ,26,15,11,11
L37 2LL,L37,2LL,26,15,11,11
L37 2LN,L37,2LN,50,28,22,16
L37 2LP,L37,2LP,23,11,12,12
L37 2LQ,L37,2LQ,28,13,15,12
L37 2LR,L37,2LR,94,48,46,37
L37 2LS,L37,2LS,41,16,25,17
L37 2LT,L37,2LT,59,29,30,21
L37 2LU,L37,2LU,28,16,12,11
L37 2LW,L37,2LW,56,28,28,21
L37 2LX,L37,2LX,132,61,71,50
L37 2LY,L37,2LY,76,37,39,29
L37 2YA,L37,2YA,24,13,11,6
L37 2YB,L37,2YB,14,5,9,6
L37 2YD,L37,2YD,50,23,27,20
L37 2YE,L37,2YE,33,15,18,16
L37 2YF,L37,2YF,51,24,27,21
L37 2YG,L37,2YG,19,6,13,8
L37 2YH,L37,2YH,35,20,15,14
L37 2YJ,L37,2YJ,39,19,20,17
L37 2YN,L37,2YN,83,39,44,32
L37 2YP,L37,2YP,41,20,21,14
L37 2YQ,L37,2YQ,69,32,37,24
L37 2YR,L37,2YR,20,8,12,8
L37 2YS,L37,2YS,99,56,43,36
L37 2YT,L37,2YT,83,40,43,32
L37 2YU,L37,2YU,18,9,9,8
L37 2YW,L37,2YW,30,13,17,15
L37 2YX,L37,2YX,20,8,12,9
L37 2YY,L37,2YY,29,15,14,10
L37 2YZ,L37,2YZ,20,12,8,8
L37 3HA,L37,3HA,84,42,42,32
L37 3HB,L37,3HB,94,53,41,41
L37 3HD,L37,3HD,69,34,35,28
L37 3HE,L37,3HE,55,24,31,24
L37 3HF,L37,3HF,43,18,25,18
L37 3HG,L37,3HG,64,25,39,30
L37 3HH,L37,3HH,84,38,46,32
L37 3HJ,L37,3HJ,44,18,26,14
L37 3HL,L37,3HL,62,31,31,21
L37 3HN,L37,3HN,36,18,18,13
L37 3HP,L37,3HP,43,17,26,27
L37 3HQ,L37,3HQ,76,33,43,26
L37 3HR,L37,3HR,11,4,7,5
L37 3HS,L37,3HS,14,4,10,11
L37 3HT,L37,3HT,8,5,3,5
L37 3HU,L37,3HU,18,9,9,11
L37 3HW,L37,3HW,35,13,22,12
L37 3HX,L37,3HX,9,3,6,5
L37 3HY,L37,3HY,48,20,28,19
L37 3HZ,L37,3HZ,35,16,19,18
L37 3JA,L37,3JA,40,22,18,16
L37 3JB,L37,3JB,45,16,29,17
L37 3JD,L37,3JD,21,9,12,10
L37 3JE,L37,3JE,40,23,17,20
L37 3JF,L37,3JF,29,13,16,13
L37 3JG,L37,3JG,26,13,13,12
L37 3JH,L37,3JH,42,24,18,15
L37 3JJ,L37,3JJ,12,5,7,3
L37 3JL,L37,3JL,58,28,30,22
L37 3JN,L37,3JN,37,15,22,14
L37 3JP,L37,3JP,15,7,8,6
L37 3JQ,L37,3JQ,28,14,14,9
L37 3JS,L37,3JS,43,20,23,17
L37 3JT,L37,3JT,30,13,17,18
L37 3JU,L37,3JU,93,38,55,46
L37 3JW,L37,3JW,13,8,5,5
L37 3JX,L37,3JX,50,27,23,19
L37 3JY,L37,3JY,23,11,12,10
L37 3JZ,L37,3JZ,27,13,14,14
L37 3LA,L37,3LA,53,25,28,23
L37 3LB,L37,3LB,51,23,28,21
L37 3LD,L37,3LD,50,26,24,22
L37 3LE,L37,3LE,38,14,24,18
L37 3LF,L37,3LF,26,12,14,13
L37 3LG,L37,3LG,15,8,7,9
L37 3LH,L37,3LH,21,9,12,11
L37 3LJ,L37,3LJ,40,14,26,24
L37 3LL,L37,3LL,34,21,13,15
L37 3LN,L37,3LN,57,21,36,10
L37 3LP,L37,3LP,4,2,2,2
L37 3LQ,L37,3LQ,59,30,29,23
L37 3LR,L37,3LR,47,18,29,18
L37 3LS,L37,3LS,50,22,28,20
L37 3LT,L37,3LT,49,28,21,21
L37 3LU,L37,3LU,116,50,66,32
L37 3LW,L37,3LW,5,4,1,5
L37 3LX,L37,3LX,70,38,32,31
L37 3LY,L37,3LY,104,48,56,44
L37 3LZ,L37,3LZ,29,13,16,11
L37 3NA,L37,3NA,45,25,20,19
L37 3NB,L37,3NB,15,10,5,4
L37 3ND,L37,3ND,47,25,22,20
L37 3NF,L37,3NF,23,14,9,14
L37 3NG,L37,3NG,33,18,15,13
L37 3NH,L37,3NH,29,16,13,10
L37 3NN,L37,3NN,25,16,9,12
L37 3NP,L37,3NP,13,7,6,4
L37 3NR,L37,3NR,80,40,40,32
L37 3NS,L37,3NS,68,31,37,26
L37 3NT,L37,3NT,57,30,27,22
L37 3NU,L37,3NU,13,8,5,6
L37 3NW,L37,3NW,79,36,43,30
L37 3NX,L37,3NX,45,17,28,26
L37 3NY,L37,3NY,28,15,13,15
L37 3NZ,L37,3NZ,51,21,30,18
L37 3PA,L37,3PA,108,53,55,35
L37 3PB,L37,3PB,88,46,42,34
L37 3PD,L37,3PD,15,8,7,7
L37 3PE,L37,3PE,93,44,49,37
L37 3PF,L37,3PF,64,33,31,24
L37 3PH,L37,3PH,61,29,32,24
L37 3PJ,L37,3PJ,62,32,30,30
L37 3PL,L37,3PL,8,5,3,4
L37 3PN,L37,3PN,98,41,57,63
L37 3PP,L37,3PP,54,18,36,38
L37 3PR,L37,3PR,99,36,63,56
L37 3PS,L37,3PS,101,42,59,76
L37 3PT,L37,3PT,14,6,8,9
L37 3PU,L37,3PU,18,7,11,13
L37 3PY,L37,3PY,14,6,8,10
L37 3QE,L37,3QE,19,7,12,12
L37 3QF,L37,3QF,15,7,8,9
L37 3QG,L37,3QG,27,13,14,12
L37 3QL,L37,3QL,17,8,9,9
L37 3QN,L37,3QN,9,2,7,5
L37 3QP,L37,3QP,29,12,17,24
L37 3QQ,L37,3QQ,6,4,2,2
L37 3QS,L37,3QS,23,13,10,9
L37 3QW,L37,3QW,17,8,9,6
L37 3QX,L37,3QX,5,3,2,2
L37 3RB,L37,3RB,19,10,9,7
L37 3RL,L37,3RL,13,6,7,4
L37 3RQ,L37,3RQ,9,4,5,3
L37 3RW,L37,3RW,118,58,60,40
L37 4AA,L37,4AA,87,44,43,32
L37 4AB,L37,4AB,30,15,15,12
L37 4AD,L37,4AD,45,23,22,23
L37 4AF,L37,4AF,8,5,3,4
L37 4AG,L37,4AG,20,9,11,10
L37 4AJ,L37,4AJ,20,9,11,6
L37 4AL,L37,4AL,12,6,6,6
L37 4AN,L37,4AN,13,9,4,8
L37 4AP,L37,4AP,58,24,34,25
L37 4AQ,L37,4AQ,1,0,1,1
L37 4AR,L37,4AR,35,20,15,13
L37 4AS,L37,4AS,12,3,9,8
L37 4AT,L37,4AT,69,35,34,21
L37 4AX,L37,4AX,33,14,19,19
L37 4AY,L37,4AY,37,21,16,13
L37 4AZ,L37,4AZ,55,27,28,18
L37 4BA,L37,4BA,30,14,16,14
L37 4BB,L37,4BB,53,26,27,18
L37 4BD,L37,4BD,14,7,7,6
L37 4BE,L37,4BE,34,18,16,16
L37 4BG,L37,4BG,30,14,16,12
L37 4BH,L37,4BH,15,5,10,5
L37 4BJ,L37,4BJ,9,6,3,4
L37 4BL,L37,4BL,27,17,10,9
L37 4BN,L37,4BN,17,8,9,7
L37 4BP,L37,4BP,31,12,19,20
L37 4BQ,L37,4BQ,72,29,43,30
L37 4BR,L37,4BR,30,15,15,10
L37 4BS,L37,4BS,25,10,15,11
L37 4BT,L37,4BT,40,16,24,19
L37 4BU,L37,4BU,63,31,32,26
L37 4BW,L37,4BW,32,12,20,14
L37 4BX,L37,4BX,40,20,20,21
L37 4BY,L37,4BY,27,12,15,16
L37 4BZ,L37,4BZ,29,15,14,10
L37 4DA,L37,4DA,11,4,7,7
L37 4DB,L37,4DB,55,23,32,21
L37 4DD,L37,4DD,64,32,32,26
L37 4DE,L37,4DE,45,20,25,15
L37 4DF,L37,4DF,29,10,19,15
L37 4DG,L37,4DG,65,30,35,27
L37 4DH,L37,4DH,50,21,29,23
L37 4DJ,L37,4DJ,22,12,10,12
L37 4DL,L37,4DL,4,1,3,3
L37 4DQ,L37,4DQ,47,23,24,14
L37 4DU,L37,4DU,2,2,0,2
L37 4ED,L37,4ED,24,12,12,12
L37 4EG,L37,4EG,44,21,23,19
L37 4EH,L37,4EH,29,13,16,12
L37 4EJ,L37,4EJ,30,14,16,12
L37 4EL,L37,4EL,30,16,14,12
L37 4EN,L37,4EN,59,30,29,19
L37 4EP,L37,4EP,49,27,22,18
L37 4EQ,L37,4EQ,79,39,40,35
L37 4ER,L37,4ER,21,10,11,9
L37 4ES,L37,4ES,35,16,19,15
L37 4ET,L37,4ET,29,13,16,17
L37 4EU,L37,4EU,53,23,30,24
L37 4EW,L37,4EW,20,9,11,8
L37 4EX,L37,4EX,11,5,6,5
L37 4EY,L37,4EY,50,29,21,19
L37 4EZ,L37,4EZ,21,14,7,9
L37 4FB,L37,4FB,32,10,22,27
L37 4HA,L37,4HA,17,5,12,11
L37 4HB,L37,4HB,39,27,12,14
L37 4HD,L37,4HD,110,53,57,40
L37 4HE,L37,4HE,67,29,38,30
L37 4HF,L37,4HF,36,18,18,17
L37 4HG,L37,4HG,30,16,14,14
L37 4HH,L37,4HH,13,8,5,5
L37 4HJ,L37,4HJ,45,20,25,21
L37 4HL,L37,4HL,35,17,18,13
L37 4HQ,L37,4HQ,23,12,11,7
L37 4HR,L37,4HR,14,8,6,5
L37 4HT,L37,4HT,22,13,9,7
L37 4HX,L37,4HX,26,17,9,11
L37 4HY,L37,4HY,13,6,7,5
L37 4JF,L37,4JF,31,16,15,13
L37 4JG,L37,4JG,16,8,8,8
L37 4JP,L37,4JP,126,65,61,44
L37 4LF,L37,4LF,21,10,11,6
L37 5AA,L37,5AA,7,4,3,4
L37 5AB,L37,5AB,24,12,12,14
L37 5AD,L37,5AD,9,4,5,4
L37 5AE,L37,5AE,16,7,9,6
L37 5AF,L37,5AF,3,1,2,2
L37 5AG,L37,5AG,15,9,6,7
L37 5AH,L37,5AH,9,5,4,4
L37 5AJ,L37,5AJ,27,13,14,11
L37 5AL,L37,5AL,6,1,5,3
L37 5AN,L37,5AN,2,1,1,1
L37 5AQ,L37,5AQ,20,10,10,7
L37 6AA,L37,6AA,47,25,22,20
L37 6AB,L37,6AB,50,29,21,19
L37 6AD,L37,6AD,46,19,27,25
L37 6AE,L37,6AE,9,6,3,4
L37 6AF,L37,6AF,50,24,26,19
L37 6AG,L37,6AG,22,13,9,10
L37 6AH,L37,6AH,9,4,5,3
L37 6AL,L37,6AL,5,3,2,2
L37 6AN,L37,6AN,24,12,12,10
L37 6AP,L37,6AP,23,13,10,10
L37 6AQ,L37,6AQ,61,29,32,24
L37 6AR,L37,6AR,62,32,30,26
L37 6AS,L37,6AS,50,26,24,22
L37 6AT,L37,6AT,41,19,22,16
L37 6AU,L37,6AU,28,13,15,13
L37 6AW,L37,6AW,43,22,21,21
L37 6AX,L37,6AX,51,23,28,18
L37 6AY,L37,6AY,45,20,25,17
L37 6AZ,L37,6AZ,44,22,22,19
L37 6BA,L37,6BA,117,57,60,52
L37 6BB,L37,6BB,36,16,20,13
L37 6BD,L37,6BD,19,8,11,9
L37 6BE,L37,6BE,25,12,13,12
L37 6BG,L37,6BG,89,37,52,34
L37 6BH,L37,6BH,19,9,10,8
L37 6BJ,L37,6BJ,110,54,56,40
L37 6BL,L37,6BL,59,27,32,22
L37 6BN,L37,6BN,92,47,45,34
L37 6BP,L37,6BP,99,46,53,33
L37 6BQ,L37,6BQ,70,36,34,26
L37 6BR,L37,6BR,15,9,6,6
L37 6BS,L37,6BS,26,12,14,11
L37 6BT,L37,6BT,24,11,13,9
L37 6BU,L37,6BU,37,15,22,21
L37 6BW,L37,6BW,52,20,32,19
L37 6BY,L37,6BY,6,2,4,4
L37 6BZ,L37,6BZ,42,18,24,14
L37 6DA,L37,6DA,13,6,7,6
L37 6DB,L37,6DB,74,32,42,32
L37 6DD,L37,6DD,35,18,17,12
L37 6DE,L37,6DE,38,16,22,15
L37 6DF,L37,6DF,60,31,29,22
L37 6DG,L37,6DG,10,7,3,6
L37 6DH,L37,6DH,35,13,22,22
L37 6DJ,L37,6DJ,24,11,13,11
L37 6DL,L37,6DL,53,23,30,23
L37 6DN,L37,6DN,48,22,26,23
L37 6DP,L37,6DP,35,12,23,21
L37 6DQ,L37,6DQ,25,15,10,11
L37 6DR,L37,6DR,56,23,33,27
L37 6DS,L37,6DS,42,18,24,21
L37 6DT,L37,6DT,28,12,16,14
L37 6DU,L37,6DU,8,6,2,2
L37 6DW,L37,6DW,32,10,22,18
L37 6DX,L37,6DX,51,26,25,20
L37 6DY,L37,6DY,53,24,29,21
L37 6DZ,L37,6DZ,30,18,12,10
L37 6EA,L37,6EA,29,12,17,14
L37 6EB,L37,6EB,31,17,14,16
L37 6ED,L37,6ED,45,21,24,13
L37 6EE,L37,6EE,51,23,28,18
L37 6EF,L37,6EF,44,24,20,18
L37 6EG,L37,6EG,22,9,13,9
L37 6EH,L37,6EH,21,9,12,12
L37 6EJ,L37,6EJ,36,16,20,17
L37 6EL,L37,6EL,29,14,15,12
L37 6EN,L37,6EN,61,33,28,29
L37 6EP,L37,6EP,21,9,12,11
L37 6EQ,L37,6EQ,36,18,18,14
L37 6ER,L37,6ER,47,25,22,16
L37 6ES,L37,6ES,37,20,17,16
L37 6ET,L37,6ET,14,8,6,7
L37 6EW,L37,6EW,41,20,21,18
L37 6EY,L37,6EY,46,20,26,21
L37 6HD,L37,6HD,6,4,2,2
L37 7AD,L37,7AD,1,0,1,1
L37 7AF,L37,7AF,14,8,6,5
L37 7AG,L37,7AG,26,8,18,9
L37 7AH,L37,7AH,45,17,28,27
L37 7AJ,L37,7AJ,22,13,9,6
L37 7AL,L37,7AL,17,7,10,7
L37 7AN,L37,7AN,30,13,17,18
L37 7AP,L37,7AP,11,5,6,4
L37 7AQ,L37,7AQ,38,21,17,14
L37 7AR,L37,7AR,49,18,31,22
L37 7AS,L37,7AS,62,28,34,22
L37 7AT,L37,7AT,58,31,27,26
L37 7AU,L37,7AU,17,9,8,7
L37 7AW,L37,7AW,45,21,24,16
L37 7AX,L37,7AX,24,13,11,10
L37 7AY,L37,7AY,39,20,19,14
L37 7AZ,L37,7AZ,2,2,0,0
L37 7BA,L37,7BA,35,14,21,11
L37 7BB,L37,7BB,10,4,6,3
L37 7BD,L37,7BD,65,33,32,26
L37 7BE,L37,7BE,57,25,32,26
L37 7BG,L37,7BG,37,18,19,14
L37 7BH,L37,7BH,24,12,12,8
L37 7BJ,L37,7BJ,6,3,3,4
L37 7BL,L37,7BL,20,10,10,11
L37 7BN,L37,7BN,35,17,18,12
L37 7BP,L37,7BP,12,7,5,7
L37 7BQ,L37,7BQ,28,14,14,13
L37 7BR,L37,7BR,76,40,36,28
L37 7BS,L37,7BS,12,5,7,6
L37 7BT,L37,7BT,12,7,5,3
L37 7BU,L37,7BU,41,17,24,17
L37 7BW,L37,7BW,29,16,13,9
L37 7BX,L37,7BX,21,13,8,10
L37 7BY,L37,7BY,33,17,16,15
L37 7BZ,L37,7BZ,27,11,16,13
L37 7DA,L37,7DA,21,11,10,9
L37 7DB,L37,7DB,10,3,7,6
L37 7DD,L37,7DD,24,11,13,9
L37 7DE,L37,7DE,41,21,20,15
L37 7DF,L37,7DF,57,28,29,25
L37 7DG,L37,7DG,67,36,31,21
L37 7DH,L37,7DH,55,28,27,22
L37 7DJ,L37,7DJ,37,17,20,15
L37 7DL,L37,7DL,32,14,18,12
L37 7DN,L37,7DN,49,29,20,19
L37 7DP,L37,7DP,27,14,13,11
L37 7DQ,L37,7DQ,62,29,33,25
L37 7DR,L37,7DR,35,15,20,11
L37 7DT,L37,7DT,52,22,30,18
L37 7DU,L37,7DU,24,9,15,10
L37 7DW,L37,7DW,27,14,13,13
L37 7DX,L37,7DX,41,18,23,18
L37 7DY,L37,7DY,86,42,44,34
L37 7EA,L37,7EA,64,33,31,23
L37 7EB,L37,7EB,3,2,1,2
L37 7ED,L37,7ED,12,3,9,3
L37 7EE,L37,7EE,72,27,45,29
L37 7EF,L37,7EF,81,32,49,33
L37 7EG,L37,7EG,38,18,20,16
L37 7EH,L37,7EH,47,24,23,22
L37 7EJ,L37,7EJ,39,17,22,18
L37 7EL,L37,7EL,43,22,21,18
L37 7EN,L37,7EN,46,19,27,22
L37 7EP,L37,7EP,47,23,24,25
L37 7EQ,L37,7EQ,58,29,29,25
L37 7ER,L37,7ER,31,17,14,13
L37 7ES,L37,7ES,41,18,23,16
L37 7ET,L37,7ET,39,18,21,16
L37 7EU,L37,7EU,36,18,18,17
L37 7EW,L37,7EW,54,30,24,20
L37 7EX,L37,7EX,25,12,13,10
L37 7EY,L37,7EY,63,34,29,28
L37 7EZ,L37,7EZ,34,20,14,15
L37 7FD,L37,7FD,26,13,13,14
L37 7HA,L37,7HA,111,58,53,55
L37 7HB,L37,7HB,11,6,5,3
L37 7HD,L37,7HD,52,23,29,23
L37 7HE,L37,7HE,59,27,32,24
L37 7HF,L37,7HF,30,16,14,14
L37 7HG,L37,7HG,52,28,24,21
L37 7HH,L37,7HH,15,6,9,10
L37 7HJ,L37,7HJ,13,7,6,5
L37 7HL,L37,7HL,102,46,56,42
L37 7HN,L37,7HN,36,20,16,16
L37 7HP,L37,7HP,87,40,47,42
L37 7HQ,L37,7HQ,63,29,34,27
L37 7HR,L37,7HR,18,10,8,8
L37 7HS,L37,7HS,28,10,18,18
L37 7HW,L37,7HW,26,13,13,11
L37 7HX,L37,7HX,33,18,15,13
L37 7HY,L37,7HY,20,11,9,8
L37 7HZ,L37,7HZ,62,28,34,25
L37 7JD,L37,7JD,12,6,6,4
L37 7JL,L37,7JL,23,12,11,7
L37 8BA,L37,8BA,40,18,22,21
L37 8BB,L37,8BB,46,15,31,19
L37 8BD,L37,8BD,29,13,16,13
L37 8BE,L37,8BE,58,25,33,27
L37 8BG,L37,8BG,43,21,22,23
L37 8BH,L37,8BH,97,50,47,41
L37 8BJ,L37,8BJ,28,14,14,14
L37 8BL,L37,8BL,15,7,8,8
L37 8BN,L37,8BN,21,11,10,7
L37 8BP,L37,8BP,28,14,14,14
L37 8BQ,L37,8BQ,68,30,38,48
L37 8BR,L37,8BR,23,10,13,11
L37 8BS,L37,8BS,39,19,20,15
L37 8BT,L37,8BT,58,26,32,24
L37 8BU,L37,8BU,32,15,17,14
L37 8BW,L37,8BW,14,6,8,5
L37 8BX,L37,8BX,13,7,6,6
L37 8BY,L37,8BY,96,48,48,46
L37 8BZ,L37,8BZ,77,41,36,36
L37 8DA,L37,8DA,26,11,15,15
L37 8DB,L37,8DB,34,19,15,14
L37 8DD,L37,8DD,91,43,48,39
L37 8DE,L37,8DE,59,23,36,25
L37 8DF,L37,8DF,63,29,34,28
L37 8DG,L37,8DG,73,38,35,31
L37 8DH,L37,8DH,35,15,20,16
L37 8DJ,L37,8DJ,32,14,18,12
L37 8DN,L37,8DN,11,5,6,7
L37 8DQ,L37,8DQ,75,34,41,27
L37 8DR,L37,8DR,60,33,27,18
L37 8DS,L37,8DS,58,31,27,20
L37 8DT,L37,8DT,43,19,24,22
L37 8DU,L37,8DU,1,0,1,1
L37 8DX,L37,8DX,70,35,35,30
L37 8DY,L37,8DY,23,10,13,11
L37 8DZ,L37,8DZ,78,36,42,30
L37 8EA,L37,8EA,12,6,6,8
L37 8EB,L37,8EB,91,46,45,46
L37 8ED,L37,8ED,16,8,8,5
L37 8EE,L37,8EE,30,13,17,11
L37 8EF,L37,8EF,7,3,4,4
L37 8EN,L37,8EN,12,4,8,6
L37 8RP,L37,8RP,9,1,8,3
L37 9BA,L37,9BA,10,5,5,4
L37 9BB,L37,9BB,8,4,4,3
L37 9BE,L37,9BE,11,6,5,4
L37 9BG,L37,9BG,6,3,3,2
L37 9BQ,L37,9BQ,5,2,3,2
L38 0BA,L38,0BA,27,15,12,16
L38 0BB,L38,0BB,32,16,16,10
L38 0BD,L38,0BD,26,13,13,9
L38 0BE,L38,0BE,21,10,11,8
L38 0BG,L38,0BG,58,30,28,29
L38 0BH,L38,0BH,35,18,17,17
L38 0BJ,L38,0BJ,26,11,15,15
L38 0BL,L38,0BL,40,21,19,13
L38 0BN,L38,0BN,18,8,10,10
L38 0BP,L38,0BP,31,16,15,10
L38 0BQ,L38,0BQ,30,14,16,19
L38 0BR,L38,0BR,30,14,16,14
L38 0BS,L38,0BS,28,14,14,14
L38 0BT,L38,0BT,21,8,13,11
L38 0BU,L38,0BU,76,40,36,41
L38 0BW,L38,0BW,6,2,4,4
L38 0DB,L38,0DB,21,12,9,6
L38 1QA,L38,1QA,4,3,1,3
L38 1QB,L38,1QB,16,10,6,10
L38 1QD,L38,1QD,27,11,16,12
L38 1QE,L38,1QE,72,40,32,25
L38 1QF,L38,1QF,17,6,11,5
L38 1QG,L38,1QG,49,22,27,24
L38 1QH,L38,1QH,21,11,10,7
L38 1QQ,L38,1QQ,11,5,6,3
L38 3RA,L38,3RA,5,2,3,3
L38 3RB,L38,3RB,9,7,2,2
L38 3RD,L38,3RD,8,4,4,4
L38 3RE,L38,3RE,25,12,13,8
L38 3RF,L38,3RF,7,5,2,2
L38 3RG,L38,3RG,4,2,2,2
L38 3RH,L38,3RH,11,6,5,4
L38 3RJ,L38,3RJ,21,9,12,7
L38 3RL,L38,3RL,11,4,7,5
L38 3RN,L38,3RN,37,17,20,12
L38 3RP,L38,3RP,27,16,11,10
L38 3RQ,L38,3RQ,24,11,13,8
L38 3RR,L38,3RR,14,8,6,4
L38 3RS,L38,3RS,10,5,5,3
L38 3RT,L38,3RT,29,14,15,11
L38 3RU,L38,3RU,8,4,4,4
L38 3RW,L38,3RW,31,12,19,12
L38 3RX,L38,3RX,1,1,0,1
L38 3RY,L38,3RY,10,5,5,4
L38 3RZ,L38,3RZ,13,7,6,5
L38 3SF,L38,3SF,2,1,1,1
L38 3SG,L38,3SG,3,2,1,1
L38 4JB,L38,4JB,5,3,2,2
L38 5DA,L38,5DA,12,7,5,3
L38 5DB,L38,5DB,3,1,2,1
L38 5DE,L38,5DE,13,5,8,6
L38 6JA,L38,6JA,25,11,14,13
L38 6JB,L38,6JB,13,8,5,4
L38 6JD,L38,6JD,11,7,4,5
L38 6JE,L38,6JE,35,15,20,16
L38 6JF,L38,6JF,51,21,30,21
L38 6JG,L38,6JG,5,3,2,3
L38 6JH,L38,6JH,7,2,5,3
L38 6JJ,L38,6JJ,23,10,13,10
L38 6JL,L38,6JL,34,11,23,1
L38 6JQ,L38,6JQ,25,9,16,14
L38 7JB,L38,7JB,4,2,2,4
L38 7JD,L38,7JD,8,4,4,4
L38 8AF,L38,8AF,5,2,3,3
L38 9AN,L38,9AN,172,89,83,73
L38 9AW,L38,9AW,33,16,17,12
L38 9EA,L38,9EA,11,6,5,6
L38 9EB,L38,9EB,24,12,12,8
L38 9ED,L38,9ED,28,15,13,10
L38 9EE,L38,9EE,61,29,32,25
L38 9EF,L38,9EF,83,37,46,31
L38 9EG,L38,9EG,57,28,29,23
L38 9EH,L38,9EH,21,12,9,11
L38 9EJ,L38,9EJ,38,18,20,16
L38 9EL,L38,9EL,21,9,12,14
L38 9EN,L38,9EN,20,10,10,13
L38 9EP,L38,9EP,26,12,14,13
L38 9EQ,L38,9EQ,80,41,39,31
L38 9ER,L38,9ER,31,15,16,14
L38 9ES,L38,9ES,31,13,18,12
L38 9ET,L38,9ET,11,4,7,6
L38 9EU,L38,9EU,7,3,4,3
L38 9EW,L38,9EW,21,11,10,11
L38 9EX,L38,9EX,88,41,47,38
L38 9EY,L38,9EY,79,35,44,38
L38 9EZ,L38,9EZ,34,17,17,18
L38 9GE,L38,9GE,58,28,30,26
L38 9GF,L38,9GF,49,22,27,22
L38 9GG,L38,9GG,15,9,6,8
L38 9GH,L38,9GH,52,27,25,19
L38 9GJ,L38,9GJ,30,17,13,11
L38 9GL,L38,9GL,29,13,16,14
L38 9GQ,L38,9GQ,33,19,14,14
L39 0EA,L39,0EA,23,11,12,11
L39 0EB,L39,0EB,58,27,31,30
L39 0ED,L39,0ED,31,17,14,18
L39 0EE,L39,0EE,16,8,8,6
L39 0EF,L39,0EF,45,22,23,16
L39 0EG,L39,0EG,50,26,24,18
L39 0EH,L39,0EH,18,7,11,7
L39 0EJ,L39,0EJ,10,5,5,4
L39 0EL,L39,0EL,12,6,6,10
L39 0EN,L39,0EN,14,7,7,4
L39 0EP,L39,0EP,13,6,7,3
L39 0EQ,L39,0EQ,82,42,40,37
L39 0ER,L39,0ER,27,13,14,12
L39 0ES,L39,0ES,10,4,6,4
L39 0ET,L39,0ET,79,41,38,28
L39 0EU,L39,0EU,45,20,25,22
L39 0EW,L39,0EW,3,2,1,1
L39 0EX,L39,0EX,33,15,18,14
L39 0EY,L39,0EY,23,11,12,10
L39 0EZ,L39,0EZ,41,19,22,18
L39 0HA,L39,0HA,2,1,1,1
L39 0HB,L39,0HB,111,55,56,49
L39 0HD,L39,0HD,28,15,13,12
L39 0HE,L39,0HE,24,12,12,12
L39 0HF,L39,0HF,37,20,17,14
L39 0HH,L39,0HH,42,20,22,16
L39 0HJ,L39,0HJ,14,8,6,4
L39 0HL,L39,0HL,15,6,9,7
L39 0HN,L39,0HN,4,1,3,1
L39 0HP,L39,0HP,17,8,9,7
L39 0HQ,L39,0HQ,2,1,1,1
L39 0HR,L39,0HR,48,24,24,16
L39 0HW,L39,0HW,15,8,7,5
L39 0HX,L39,0HX,12,7,5,5
L39 0JB,L39,0JB,4,2,2,2
L39 1LA,L39,1LA,27,10,17,15
L39 1LB,L39,1LB,32,16,16,17
L39 1LD,L39,1LD,26,8,18,14
L39 1LE,L39,1LE,77,40,37,29
L39 1LF,L39,1LF,96,49,47,42
L39 1LG,L39,1LG,192,84,108,54
L39 1LH,L39,1LH,34,19,15,17
L39 1LJ,L39,1LJ,82,44,38,31
L39 1LL,L39,1LL,64,30,34,31
L39 1LN,L39,1LN,80,42,38,21
L39 1LP,L39,1LP,116,63,53,44
L39 1LQ,L39,1LQ,86,42,44,40
L39 1LR,L39,1LR,85,41,44,35
L39 1LS,L39,1LS,6,1,5,3
L39 1LT,L39,1LT,13,8,5,7
L39 1LU,L39,1LU,19,11,8,8
L39 1LW,L39,1LW,102,48,54,45
L39 1LX,L39,1LX,70,36,34,28
L39 1LZ,L39,1LZ,116,53,63,52
L39 1NA,L39,1NA,10,1,9,8
L39 1NB,L39,1NB,97,46,51,39
L39 1ND,L39,1ND,99,36,63,69
L39 1NE,L39,1NE,15,7,8,7
L39 1NF,L39,1NF,59,31,28,22
L39 1NG,L39,1NG,67,30,37,35
L39 1NH,L39,1NH,76,34,42,31
L39 1NJ,L39,1NJ,110,49,61,39
L39 1NL,L39,1NL,88,39,49,59
L39 1NN,L39,1NN,58,35,23,24
L39 1NP,L39,1NP,90,43,47,33
L39 1NQ,L39,1NQ,42,21,21,17
L39 1NR,L39,1NR,86,43,43,34
L39 1NS,L39,1NS,57,31,26,21
L39 1NT,L39,1NT,38,21,17,17
L39 1NU,L39,1NU,62,33,29,24
L39 1NX,L39,1NX,104,40,64,38
L39 1NY,L39,1NY,42,22,20,19
L39 1PA,L39,1PA,83,42,41,43
L39 1PB,L39,1PB,86,43,43,39
L39 1PD,L39,1PD,86,39,47,36
L39 1PE,L39,1PE,33,20,13,13
L39 1PF,L39,1PF,12,4,8,7
L39 1PG,L39,1PG,86,43,43,38
L39 1PH,L39,1PH,55,21,34,26
L39 1PJ,L39,1PJ,81,35,46,30
L39 1PL,L39,1PL,68,37,31,26
L39 1PN,L39,1PN,110,51,59,37
L39 1PP,L39,1PP,53,24,29,27
L39 1PQ,L39,1PQ,93,47,46,31
L39 1PR,L39,1PR,46,20,26,20
L39 1PS,L39,1PS,60,32,28,17
L39 1PT,L39,1PT,41,19,22,20
L39 1PU,L39,1PU,93,47,46,47
L39 1PW,L39,1PW,109,56,53,40
L39 1PX,L39,1PX,52,26,26,23
L39 1PY,L39,1PY,110,56,54,42
L39 1PZ,L39,1PZ,83,40,43,35
L39 1QA,L39,1QA,75,31,44,26
L39 1QB,L39,1QB,84,38,46,33
L39 1QD,L39,1QD,55,27,28,20
L39 1QE,L39,1QE,96,50,46,33
L39 1QF,L39,1QF,61,32,29,22
L39 1QG,L39,1QG,53,26,27,22
L39 1QH,L39,1QH,64,37,27,25
L39 1QJ,L39,1QJ,17,9,8,11
L39 1QL,L39,1QL,39,22,17,13
L39 1QN,L39,1QN,97,49,48,45
L39 1QP,L39,1QP,16,7,9,8
L39 1QQ,L39,1QQ,72,30,42,22
L39 1QW,L39,1QW,7,4,3,3
L39 1RH,L39,1RH,69,37,32,42
L39 1RL,L39,1RL,78,33,45,28
L39 1RN,L39,1RN,33,17,16,14
L39 1RS,L39,1RS,4,2,2,4
L39 2AA,L39,2AA,33,8,25,11
L39 2AG,L39,2AG,7,4,3,2
L39 2AH,L39,2AH,16,4,12,3
L39 2AP,L39,2AP,179,86,93,52
L39 2AQ,L39,2AQ,2,1,1,1
L39 2AS,L39,2AS,48,20,28,22
L39 2AT,L39,2AT,72,34,38,26
L39 2AU,L39,2AU,53,27,26,19
L39 2AW,L39,2AW,7,3,4,4
L39 2AZ,L39,2AZ,5,1,4,0
L39 2BA,L39,2BA,128,54,74,35
L39 2BB,L39,2BB,43,20,23,15
L39 2BD,L39,2BD,36,20,16,14
L39 2BE,L39,2BE,11,6,5,4
L39 2BG,L39,2BG,97,48,49,32
L39 2BH,L39,2BH,39,20,19,17
L39 2BJ,L39,2BJ,5,3,2,2
L39 2BQ,L39,2BQ,77,39,38,31
L39 2BW,L39,2BW,18,8,10,6
L39 2BY,L39,2BY,5,3,2,2
L39 2DD,L39,2DD,18,7,11,8
L39 2DE,L39,2DE,132,57,75,50
L39 2DH,L39,2DH,116,46,70,34
L39 2DJ,L39,2DJ,20,12,8,8
L39 2DN,L39,2DN,11,10,1,2
L39 2DP,L39,2DP,51,23,28,17
L39 2DR,L39,2DR,20,10,10,9
L39 2DS,L39,2DS,53,25,28,18
L39 2DT,L39,2DT,23,12,11,11
L39 2DU,L39,2DU,11,8,3,11
L39 2DX,L39,2DX,23,11,12,11
L39 2DY,L39,2DY,50,25,25,21
L39 2DZ,L39,2DZ,168,65,103,55
L39 2EA,L39,2EA,103,54,49,38
L39 2EB,L39,2EB,88,46,42,31
L39 2ED,L39,2ED,68,38,30,25
L39 2EE,L39,2EE,50,25,25,21
L39 2EF,L39,2EF,95,51,44,34
L39 2EG,L39,2EG,15,2,13,5
L39 2EL,L39,2EL,46,25,21,23
L39 2EP,L39,2EP,51,21,30,20
L39 2ER,L39,2ER,8,7,1,2
L39 2ES,L39,2ES,5,3,2,2
L39 2ET,L39,2ET,7,4,3,6
L39 2EU,L39,2EU,77,33,44,30
L39 2EX,L39,2EX,18,6,12,8
L39 2EY,L39,2EY,103,59,44,42
L39 2HB,L39,2HB,22,15,7,8
L39 2HD,L39,2HD,31,17,14,19
L39 2HG,L39,2HG,38,17,21,14
L39 2HH,L39,2HH,30,15,15,11
L39 2HJ,L39,2HJ,23,12,11,8
L39 2HQ,L39,2HQ,25,14,11,8
L39 2HZ,L39,2HZ,11,5,6,4
L39 2JB,L39,2JB,16,8,8,8
L39 2JN,L39,2JN,16,10,6,5
L39 2JQ,L39,2JQ,13,9,4,9
L39 2XB,L39,2XB,95,42,53,36
L39 2XD,L39,2XD,41,15,26,12
L39 2XE,L39,2XE,65,28,37,29
L39 2XF,L39,2XF,58,30,28,26
L39 2XH,L39,2XH,82,34,48,37
L39 2XJ,L39,2XJ,46,20,26,19
L39 2XP,L39,2XP,114,49,65,56
L39 2XR,L39,2XR,27,11,16,19
L39 2XY,L39,2XY,74,35,39,31
L39 2XZ,L39,2XZ,27,14,13,11
L39 2YA,L39,2YA,45,24,21,38
L39 2YF,L39,2YF,4,2,2,3
L39 2YG,L39,2YG,53,21,32,44
L39 2YH,L39,2YH,5,0,5,1
L39 2YN,L39,2YN,15,7,8,8
L39 2YP,L39,2YP,102,52,50,38
L39 2YR,L39,2YR,38,20,18,12
L39 2YS,L39,2YS,50,25,25,15
L39 2YT,L39,2YT,7,1,6,2
L39 2YU,L39,2YU,8,6,2,2
L39 2YW,L39,2YW,25,14,11,8
L39 2YX,L39,2YX,72,36,36,30
L39 3AD,L39,3AD,17,9,8,7
L39 3AE,L39,3AE,10,7,3,2
L39 3AG,L39,3AG,17,8,9,3
L39 3AJ,L39,3AJ,5,3,2,2
L39 3AL,L39,3AL,6,4,2,3
L39 3AN,L39,3AN,6,4,2,3
L39 3AP,L39,3AP,10,6,4,4
L39 3AR,L39,3AR,39,18,21,15
L39 3AS,L39,3AS,48,26,22,27
L39 3AT,L39,3AT,49,22,27,22
L39 3AU,L39,3AU,38,17,21,17
L39 3AW,L39,3AW,14,9,5,5
L39 3AX,L39,3AX,46,18,28,20
L39 3AY,L39,3AY,53,29,24,18
L39 3AZ,L39,3AZ,112,55,57,52
L39 3BA,L39,3BA,14,9,5,6
L39 3BB,L39,3BB,63,31,32,24
L39 3BD,L39,3BD,12,6,6,3
L39 3BE,L39,3BE,51,24,27,19
L39 3BG,L39,3BG,80,38,42,30
L39 3BH,L39,3BH,29,13,16,9
L39 3BL,L39,3BL,17,12,5,10
L39 3BN,L39,3BN,42,20,22,26
L39 3BS,L39,3BS,16,11,5,11
L39 3BW,L39,3BW,1,1,0,1
L39 3LB,L39,3LB,62,25,37,29
L39 3LD,L39,3LD,80,39,41,32
L39 3LF,L39,3LF,6,3,3,3
L39 3LG,L39,3LG,51,26,25,20
L39 3LH,L39,3LH,87,41,46,35
L39 3LJ,L39,3LJ,54,26,28,20
L39 3LL,L39,3LL,41,24,17,20
L39 3LN,L39,3LN,2,1,1,1
L39 3LQ,L39,3LQ,5,3,2,4
L39 3LR,L39,3LR,32,17,15,11
L39 3LS,L39,3LS,2,1,1,1
L39 3LT,L39,3LT,33,13,20,18
L39 3LU,L39,3LU,56,28,28,19
L39 3LW,L39,3LW,91,41,50,43
L39 3LY,L39,3LY,30,14,16,13
L39 3NA,L39,3NA,49,27,22,24
L39 3NB,L39,3NB,20,7,13,10
L39 3ND,L39,3ND,25,10,15,13
L39 3NE,L39,3NE,50,26,24,24
L39 3NF,L39,3NF,79,40,39,29
L39 3NG,L39,3NG,42,16,26,18
L39 3NH,L39,3NH,45,23,22,19
L39 3NJ,L39,3NJ,111,53,58,41
L39 3NL,L39,3NL,33,15,18,14
L39 3NN,L39,3NN,87,42,45,41
L39 3NP,L39,3NP,63,30,33,27
L39 3NQ,L39,3NQ,2,1,1,1
L39 3NR,L39,3NR,56,27,29,24
L39 3NS,L39,3NS,64,29,35,39
L39 3NT,L39,3NT,23,11,12,12
L39 3NU,L39,3NU,54,25,29,23
L39 3NW,L39,3NW,111,48,63,48
L39 3NX,L39,3NX,62,27,35,33
L39 3NY,L39,3NY,70,32,38,28
L39 3NZ,L39,3NZ,12,5,7,7
L39 3PA,L39,3PA,16,7,9,10
L39 3PB,L39,3PB,34,16,18,14
L39 3PD,L39,3PD,9,4,5,5
L39 3PH,L39,3PH,49,21,28,24
L39 3PJ,L39,3PJ,87,41,46,31
L39 3PL,L39,3PL,91,44,47,36
L39 3PN,L39,3PN,50,25,25,22
L39 3PU,L39,3PU,34,16,18,24
L39 3PX,L39,3PX,33,14,19,12
L39 3PY,L39,3PY,5,3,2,2
L39 3QG,L39,3QG,3,1,2,1
L39 3QH,L39,3QH,35,19,16,19
L39 3QL,L39,3QL,72,33,39,24
L39 3QN,L39,3QN,18,9,9,6
L39 3QX,L39,3QX,12,5,7,3
L39 3RD,L39,3RD,1,1,0,1
L39 3RG,L39,3RG,96,49,47,30
L39 3RH,L39,3RH,26,13,13,8
L39 3RJ,L39,3RJ,37,20,17,12
L39 3RQ,L39,3RQ,26,10,16,11
L39 4AA,L39,4AA,273,113,160,0
L39 4AB,L39,4AB,34,18,16,17
L39 4AD,L39,4AD,2,1,1,1
L39 4AH,L39,4AH,134,57,77,0
L39 4AL,L39,4AL,337,96,241,0
L39 4BH,L39,4BH,5,3,2,1
L39 4GA,L39,4GA,31,13,18,15
L39 4PL,L39,4PL,33,21,12,19
L39 4PY,L39,4PY,50,28,22,31
L39 4PZ,L39,4PZ,180,76,104,0
L39 4QA,L39,4QA,33,16,17,5
L39 4QB,L39,4QB,22,6,16,12
L39 4QD,L39,4QD,92,23,69,31
L39 4QE,L39,4QE,67,34,33,19
L39 4QF,L39,4QF,70,27,43,32
L39 4QJ,L39,4QJ,97,49,48,29
L39 4QL,L39,4QL,23,15,8,14
L39 4QQ,L39,4QQ,6,2,4,4
L39 4QR,L39,4QR,69,35,34,24
L39 4QT,L39,4QT,52,24,28,19
L39 4QU,L39,4QU,20,9,11,8
L39 4QW,L39,4QW,73,36,37,24
L39 4QX,L39,4QX,65,34,31,22
L39 4QZ,L39,4QZ,85,45,40,27
L39 4RA,L39,4RA,15,6,9,7
L39 4RB,L39,4RB,90,53,37,33
L39 4RD,L39,4RD,122,40,82,28
L39 4RE,L39,4RE,49,21,28,24
L39 4RF,L39,4RF,20,11,9,8
L39 4RG,L39,4RG,106,52,54,39
L39 4RH,L39,4RH,34,19,15,19
L39 4RJ,L39,4RJ,75,35,40,30
L39 4RL,L39,4RL,14,8,6,7
L39 4RN,L39,4RN,59,21,38,26
L39 4RQ,L39,4RQ,71,34,37,28
L39 4RR,L39,4RR,29,16,13,15
L39 4RS,L39,4RS,28,11,17,24
L39 4RT,L39,4RT,26,9,17,19
L39 4RW,L39,4RW,25,10,15,11
L39 4RY,L39,4RY,14,4,10,11
L39 4SB,L39,4SB,91,44,47,42
L39 4SD,L39,4SD,112,53,59,51
L39 4SE,L39,4SE,95,36,59,51
L39 4SF,L39,4SF,82,38,44,41
L39 4SG,L39,4SG,45,17,28,19
L39 4SH,L39,4SH,94,47,47,34
L39 4SJ,L39,4SJ,36,17,19,16
L39 4SL,L39,4SL,56,22,34,28
L39 4SN,L39,4SN,54,29,25,18
L39 4SP,L39,4SP,112,55,57,43
L39 4SQ,L39,4SQ,124,67,57,45
L39 4SR,L39,4SR,29,11,18,13
L39 4SS,L39,4SS,38,17,21,13
L39 4ST,L39,4ST,29,13,16,15
L39 4SU,L39,4SU,35,16,19,14
L39 4SW,L39,4SW,74,34,40,28
L39 4SX,L39,4SX,80,42,38,29
L39 4SY,L39,4SY,16,8,8,4
L39 4SZ,L39,4SZ,82,37,45,34
L39 4TA,L39,4TA,22,12,10,10
L39 4TB,L39,4TB,58,28,30,30
L39 4TD,L39,4TD,33,17,16,16
L39 4TE,L39,4TE,64,34,30,22
L39 4TF,L39,4TF,116,53,63,44
L39 4TG,L39,4TG,64,28,36,28
L39 4TH,L39,4TH,34,15,19,16
L39 4TJ,L39,4TJ,30,15,15,15
L39 4TL,L39,4TL,16,8,8,9
L39 4TN,L39,4TN,50,21,29,18
L39 4TP,L39,4TP,63,33,30,26
L39 4TQ,L39,4TQ,36,14,22,15
L39 4TR,L39,4TR,32,17,15,13
L39 4TS,L39,4TS,40,22,18,21
L39 4TT,L39,4TT,52,34,18,21
L39 4TU,L39,4TU,42,27,15,16
L39 4TW,L39,4TW,9,8,1,0
L39 4TX,L39,4TX,4,2,2,2
L39 4TY,L39,4TY,42,25,17,16
L39 4TZ,L39,4TZ,46,22,24,18
L39 4UA,L39,4UA,59,28,31,21
L39 4UB,L39,4UB,37,17,20,16
L39 4UD,L39,4UD,85,41,44,34
L39 4UE,L39,4UE,10,5,5,4
L39 4UF,L39,4UF,56,26,30,22
L39 4UG,L39,4UG,22,11,11,11
L39 4UH,L39,4UH,61,29,32,29
L39 4UJ,L39,4UJ,68,36,32,30
L39 4UL,L39,4UL,54,30,24,20
L39 4UN,L39,4UN,63,32,31,26
L39 4UP,L39,4UP,4,2,2,2
L39 4UQ,L39,4UQ,58,26,32,27
L39 4UR,L39,4UR,91,49,42,30
L39 4US,L39,4US,10,6,4,4
L39 4UZ,L39,4UZ,26,13,13,8
L39 4XB,L39,4XB,50,19,31,41
L39 4XD,L39,4XD,6,2,4,3
L39 4XE,L39,4XE,13,4,9,11
L39 4XF,L39,4XF,52,18,34,40
L39 4XJ,L39,4XJ,25,12,13,14
L39 4XL,L39,4XL,73,36,37,27
L39 4XN,L39,4XN,16,7,9,6
L39 4XP,L39,4XP,64,34,30,27
L39 4XR,L39,4XR,51,25,26,15
L39 4YA,L39,4YA,52,23,29,22
L39 4YE,L39,4YE,11,5,6,4
L39 4YG,L39,4YG,64,30,34,19
L39 4YH,L39,4YH,67,29,38,24
L39 4YJ,L39,4YJ,19,9,10,6
L39 4YX,L39,4YX,31,11,20,26
L39 5AA,L39,5AA,45,21,24,23
L39 5AB,L39,5AB,57,28,29,20
L39 5AD,L39,5AD,38,17,21,17
L39 5AE,L39,5AE,51,28,23,18
L39 5AF,L39,5AF,8,2,6,4
L39 5AG,L39,5AG,56,26,30,21
L39 5AH,L39,5AH,65,34,31,29
L39 5AJ,L39,5AJ,69,35,34,26
L39 5AL,L39,5AL,34,17,17,11
L39 5AN,L39,5AN,79,39,40,44
L39 5AP,L39,5AP,103,49,54,38
L39 5AQ,L39,5AQ,49,25,24,21
L39 5AR,L39,5AR,59,27,32,22
L39 5AS,L39,5AS,71,36,35,27
L39 5AT,L39,5AT,96,36,60,27
L39 5AU,L39,5AU,33,18,15,17
L39 5AW,L39,5AW,53,21,32,22
L39 5AX,L39,5AX,31,17,14,12
L39 5AY,L39,5AY,55,31,24,18
L39 5AZ,L39,5AZ,96,51,45,34
L39 5BA,L39,5BA,11,3,8,6
L39 5BB,L39,5BB,46,23,23,23
L39 5BD,L39,5BD,31,10,21,18
L39 5BE,L39,5BE,22,12,10,8
L39 5BG,L39,5BG,17,10,7,6
L39 5BH,L39,5BH,21,12,9,9
L39 5BJ,L39,5BJ,45,25,20,15
L39 5BL,L39,5BL,69,34,35,28
L39 5BN,L39,5BN,98,42,56,38
L39 5BP,L39,5BP,42,20,22,16
L39 5BQ,L39,5BQ,8,5,3,3
L39 5BR,L39,5BR,6,4,2,1
L39 5BS,L39,5BS,10,5,5,3
L39 5BT,L39,5BT,42,22,20,17
L39 5BU,L39,5BU,58,28,30,27
L39 5BW,L39,5BW,83,34,49,31
L39 5BY,L39,5BY,30,11,19,13
L39 5BZ,L39,5BZ,26,13,13,11
L39 5DA,L39,5DA,68,35,33,35
L39 5DB,L39,5DB,30,17,13,12
L39 5DD,L39,5DD,33,13,20,14
L39 5DE,L39,5DE,80,41,39,32
L39 5DF,L39,5DF,31,16,15,11
L39 5DG,L39,5DG,80,44,36,27
L39 5DH,L39,5DH,15,5,10,6
L39 5DJ,L39,5DJ,48,19,29,20
L39 5DL,L39,5DL,31,16,15,11
L39 5DN,L39,5DN,56,31,25,24
L39 5DP,L39,5DP,30,16,14,10
L39 5DQ,L39,5DQ,32,17,15,14
L39 5DR,L39,5DR,63,33,30,26
L39 5DS,L39,5DS,23,11,12,9
L39 5DT,L39,5DT,12,6,6,3
L39 5DU,L39,5DU,89,39,50,25
L39 5DW,L39,5DW,88,50,38,29
L39 5DX,L39,5DX,7,4,3,2
L39 5DY,L39,5DY,48,22,26,26
L39 5DZ,L39,5DZ,53,29,24,22
L39 5EA,L39,5EA,48,23,25,18
L39 5EB,L39,5EB,42,24,18,16
L39 5ED,L39,5ED,45,18,27,27
L39 5EE,L39,5EE,58,25,33,27
L39 5EF,L39,5EF,65,27,38,31
L39 5EG,L39,5EG,56,27,29,26
L39 5EH,L39,5EH,69,36,33,25
L39 5EJ,L39,5EJ,29,14,15,8
L39 5EL,L39,5EL,2,1,1,2
L39 5EN,L39,5EN,47,24,23,24
L39 5EP,L39,5EP,73,36,37,28
L39 5EQ,L39,5EQ,48,25,23,25
L39 5ER,L39,5ER,32,16,16,16
L39 5ES,L39,5ES,54,22,32,25
L39 5ET,L39,5ET,35,19,16,11
L39 5EU,L39,5EU,47,18,29,25
L39 5EW,L39,5EW,59,31,28,28
L39 5EX,L39,5EX,44,23,21,17
L39 5EY,L39,5EY,62,34,28,27
L39 5EZ,L39,5EZ,28,11,17,13
L39 5FB,L39,5FB,10,5,5,3
L39 5HA,L39,5HA,16,8,8,8
L39 5HB,L39,5HB,7,5,2,3
L39 5HD,L39,5HD,8,4,4,3
L39 5HE,L39,5HE,15,8,7,6
L39 5HF,L39,5HF,53,26,27,20
L39 5HJ,L39,5HJ,29,17,12,11
L39 5HL,L39,5HL,7,4,3,3
L39 5HS,L39,5HS,45,21,24,14
L39 5HX,L39,5HX,23,9,14,14
L39 5JA,L39,5JA,5,3,2,2
L39 5JQ,L39,5JQ,22,12,10,10
L39 5JX,L39,5JX,13,6,7,5
L39 5QA,L39,5QA,28,7,21,21
L39 5QB,L39,5QB,18,6,12,14
L39 5QE,L39,5QE,47,3,44,0
L39 5QF,L39,5QF,4,2,2,2
L39 5QG,L39,5QG,57,27,30,19
L39 5QH,L39,5QH,36,14,22,12
L39 5QJ,L39,5QJ,46,24,22,14
L39 5QL,L39,5QL,95,50,45,35
L39 5QQ,L39,5QQ,45,25,20,14
L39 5QS,L39,5QS,11,5,6,4
L39 5RB,L39,5RB,6,4,2,4
L39 5RD,L39,5RD,9,4,5,5
L39 5RE,L39,5RE,15,6,9,9
L39 5RF,L39,5RF,26,11,15,16
L39 6RA,L39,6RA,14,5,9,12
L39 6RB,L39,6RB,22,10,12,12
L39 6RD,L39,6RD,98,50,48,41
L39 6RE,L39,6RE,86,48,38,35
L39 6RF,L39,6RF,81,37,44,35
L39 6RG,L39,6RG,78,38,40,28
L39 6RH,L39,6RH,41,23,18,28
L39 6RJ,L39,6RJ,47,25,22,19
L39 6RL,L39,6RL,10,3,7,5
L39 6RN,L39,6RN,116,56,60,46
L39 6RP,L39,6RP,54,21,33,27
L39 6RR,L39,6RR,53,29,24,22
L39 6RS,L39,6RS,34,16,18,11
L39 6RT,L39,6RT,3,2,1,2
L39 6RU,L39,6RU,36,16,20,14
L39 6RW,L39,6RW,51,25,26,21
L39 6RX,L39,6RX,9,4,5,3
L39 6RY,L39,6RY,100,49,51,41
L39 6RZ,L39,6RZ,55,22,33,22
L39 6SA,L39,6SA,32,19,13,13
L39 6SB,L39,6SB,49,22,27,23
L39 6SD,L39,6SD,36,16,20,16
L39 6SE,L39,6SE,74,35,39,38
L39 6SF,L39,6SF,46,21,25,16
L39 6SG,L39,6SG,73,29,44,28
L39 6SH,L39,6SH,54,21,33,11
L39 6SJ,L39,6SJ,80,42,38,30
L39 6SL,L39,6SL,12,6,6,5
L39 6SN,L39,6SN,79,34,45,29
L39 6SP,L39,6SP,62,29,33,28
L39 6SQ,L39,6SQ,17,8,9,8
L39 6SR,L39,6SR,103,51,52,42
L39 6SS,L39,6SS,60,30,30,24
L39 6ST,L39,6ST,126,51,75,26
L39 6SU,L39,6SU,22,9,13,9
L39 6SW,L39,6SW,2,1,1,1
L39 6SX,L39,6SX,52,26,26,20
L39 6SY,L39,6SY,58,29,29,24
L39 6SZ,L39,6SZ,6,4,2,1
L39 6TA,L39,6TA,24,13,11,10
L39 6TB,L39,6TB,17,9,8,9
L39 6TD,L39,6TD,28,17,11,14
L39 6TE,L39,6TE,17,8,9,9
L39 6TF,L39,6TF,31,17,14,13
L39 6TG,L39,6TG,7,0,7,6
L39 6TH,L39,6TH,20,6,14,18
L39 6TJ,L39,6TJ,15,8,7,7
L39 6TQ,L39,6TQ,18,7,11,7
L39 6TR,L39,6TR,8,2,6,3
L39 6TT,L39,6TT,50,25,25,18
L39 6UH,L39,6UH,8,4,4,3
L39 7HA,L39,7HA,18,8,10,6
L39 7HB,L39,7HB,33,17,16,11
L39 7HD,L39,7HD,12,6,6,6
L39 7HE,L39,7HE,17,8,9,6
L39 7HF,L39,7HF,5,3,2,3
L39 7HG,L39,7HG,51,22,29,10
L39 7HH,L39,7HH,41,20,21,15
L39 7HJ,L39,7HJ,28,16,12,13
L39 7HL,L39,7HL,7,4,3,2
L39 7HN,L39,7HN,9,5,4,3
L39 7HP,L39,7HP,21,11,10,9
L39 7HR,L39,7HR,24,13,11,9
L39 7HS,L39,7HS,21,9,12,9
L39 7HT,L39,7HT,46,25,21,17
L39 7HU,L39,7HU,4,3,1,2
L39 7HW,L39,7HW,6,2,4,2
L39 7HX,L39,7HX,28,14,14,10
L39 7HY,L39,7HY,108,47,61,40
L39 7HZ,L39,7HZ,73,37,36,24
L39 7JA,L39,7JA,5,3,2,2
L39 7JB,L39,7JB,6,3,3,2
L39 7JD,L39,7JD,36,19,17,18
L39 7JE,L39,7JE,47,22,25,20
L39 7JF,L39,7JF,32,15,17,15
L39 7JG,L39,7JG,78,40,38,33
L39 7JH,L39,7JH,55,26,29,26
L39 7JJ,L39,7JJ,1,1,0,1
L39 7JL,L39,7JL,27,14,13,15
L39 7JN,L39,7JN,54,25,29,19
L39 7JP,L39,7JP,35,17,18,15
L39 7JR,L39,7JR,17,11,6,8
L39 7JS,L39,7JS,11,5,6,4
L39 7JT,L39,7JT,1,1,0,1
L39 7JU,L39,7JU,34,18,16,11
L39 7JW,L39,7JW,37,18,19,11
L39 7JX,L39,7JX,5,3,2,2
L39 7JY,L39,7JY,54,26,28,24
L39 7JZ,L39,7JZ,15,8,7,7
L39 7LA,L39,7LA,4,2,2,2
L39 7LB,L39,7LB,11,6,5,5
L39 7LD,L39,7LD,95,46,49,39
L39 7LE,L39,7LE,29,16,13,8
L39 7LP,L39,7LP,3,1,2,3
L39 8BB,L39,8BB,6,2,4,2
L39 8RA,L39,8RA,22,9,13,10
L39 8RB,L39,8RB,16,8,8,4
L39 8RD,L39,8RD,17,7,10,6
L39 8RE,L39,8RE,22,13,9,9
L39 8RF,L39,8RF,41,19,22,13
L39 8RG,L39,8RG,31,16,15,17
L39 8RH,L39,8RH,51,26,25,21
L39 8RJ,L39,8RJ,86,47,39,34
L39 8RL,L39,8RL,45,22,23,16
L39 8RN,L39,8RN,21,9,12,8
L39 8RP,L39,8RP,3,1,2,2
L39 8RQ,L39,8RQ,13,8,5,5
L39 8RR,L39,8RR,31,11,20,16
L39 8RS,L39,8RS,54,27,27,19
L39 8RT,L39,8RT,2,1,1,1
L39 8RU,L39,8RU,66,27,39,29
L39 8RW,L39,8RW,15,9,6,6
L39 8RX,L39,8RX,36,19,17,14
L39 8RY,L39,8RY,18,6,12,7
L39 8RZ,L39,8RZ,7,2,5,2
L39 8SA,L39,8SA,45,20,25,16
L39 8SB,L39,8SB,84,38,46,42
L39 8SD,L39,8SD,8,5,3,5
L39 8SE,L39,8SE,26,13,13,13
L39 8SF,L39,8SF,48,29,19,19
L39 8SG,L39,8SG,37,18,19,18
L39 8SH,L39,8SH,84,44,40,34
L39 8SJ,L39,8SJ,12,7,5,5
L39 8SL,L39,8SL,9,6,3,5
L39 8SN,L39,8SN,7,3,4,4
L39 8SP,L39,8SP,23,11,12,8
L39 8SQ,L39,8SQ,35,17,18,11
L39 8SR,L39,8SR,59,29,30,21
L39 8SS,L39,8SS,29,16,13,11
L39 8ST,L39,8ST,9,3,6,5
L39 8SU,L39,8SU,16,11,5,5
L39 8SW,L39,8SW,12,3,9,5
L39 8SX,L39,8SX,50,25,25,21
L39 8SY,L39,8SY,17,6,11,8
L39 8SZ,L39,8SZ,15,8,7,8
L39 8TF,L39,8TF,6,2,4,2
L39 8TL,L39,8TL,7,5,2,2
L39 8TN,L39,8TN,23,12,11,9
L39 8TQ,L39,8TQ,9,4,5,5
L39 8TR,L39,8TR,2,1,1,1
L39 9AA,L39,9AA,2,1,1,1
L39 9EA,L39,9EA,9,5,4,5
L39 9EB,L39,9EB,6,3,3,3
L39 9ED,L39,9ED,21,14,7,5
L39 9EE,L39,9EE,17,10,7,7
L39 9EF,L39,9EF,11,5,6,3
L39 9EG,L39,9EG,18,6,12,6
L39 9EH,L39,9EH,7,2,5,4
L39 9EJ,L39,9EJ,17,10,7,9
L39 9EL,L39,9EL,11,7,4,4
L39 9EN,L39,9EN,12,7,5,5
L39 9EP,L39,9EP,10,6,4,4
L39 9ER,L39,9ER,6,2,4,2
L39 9EW,L39,9EW,20,8,12,6
L4  0RA,L4,0RA,44,24,20,28
L4  0RB,L4,0RB,80,42,38,37
L4  0RD,L4,0RD,32,19,13,14
L4  0RE,L4,0RE,24,12,12,12
L4  0RG,L4,0RG,25,14,11,9
L4  0RH,L4,0RH,41,18,23,26
L4  0RJ,L4,0RJ,17,8,9,11
L4  0RL,L4,0RL,23,13,10,12
L4  0RN,L4,0RN,30,11,19,15
L4  0RP,L4,0RP,35,24,11,23
L4  0RQ,L4,0RQ,5,4,1,2
L4  0RR,L4,0RR,83,40,43,28
L4  0RS,L4,0RS,63,24,39,23
L4  0RT,L4,0RT,46,21,25,16
L4  0RU,L4,0RU,48,24,24,27
L4  0RW,L4,0RW,38,21,17,23
L4  0RX,L4,0RX,30,17,13,19
L4  0RY,L4,0RY,33,14,19,15
L4  0RZ,L4,0RZ,27,16,11,14
L4  0SA,L4,0SA,57,30,27,31
L4  0SB,L4,0SB,56,30,26,37
L4  0SD,L4,0SD,68,34,34,40
L4  0SE,L4,0SE,27,16,11,14
L4  0SF,L4,0SF,51,23,28,22
L4  0SH,L4,0SH,39,19,20,27
L4  0SJ,L4,0SJ,30,20,10,25
L4  0SL,L4,0SL,18,10,8,5
L4  0SN,L4,0SN,23,10,13,14
L4  0SP,L4,0SP,42,22,20,30
L4  0SR,L4,0SR,75,40,35,41
L4  0SS,L4,0SS,15,8,7,7
L4  0ST,L4,0ST,38,15,23,17
L4  0SU,L4,0SU,49,27,22,17
L4  0SW,L4,0SW,28,19,9,18
L4  0SX,L4,0SX,59,31,28,19
L4  0SY,L4,0SY,59,26,33,27
L4  0SZ,L4,0SZ,57,30,27,26
L4  0TA,L4,0TA,40,21,19,21
L4  0TB,L4,0TB,58,29,29,23
L4  0TD,L4,0TD,112,64,48,26
L4  0TE,L4,0TE,82,48,34,50
L4  0TF,L4,0TF,79,47,32,51
L4  0TG,L4,0TG,12,12,0,12
L4  0TJ,L4,0TJ,43,25,18,19
L4  0TL,L4,0TL,57,36,21,27
L4  0TN,L4,0TN,25,12,13,9
L4  0TP,L4,0TP,63,32,31,28
L4  0TQ,L4,0TQ,24,16,8,16
L4  0TR,L4,0TR,54,20,34,29
L4  0TS,L4,0TS,83,35,48,36
L4  0TT,L4,0TT,91,44,47,37
L4  0TY,L4,0TY,69,31,38,24
L4  0TZ,L4,0TZ,47,24,23,24
L4  0UA,L4,0UA,47,24,23,25
L4  0UB,L4,0UB,73,37,36,29
L4  0UD,L4,0UD,104,54,50,38
L4  0UE,L4,0UE,37,19,18,16
L4  0UF,L4,0UF,42,17,25,13
L4  0UH,L4,0UH,7,3,4,4
L4  0UQ,L4,0UQ,36,18,18,15
L4  1QB,L4,1QB,21,10,11,9
L4  1QD,L4,1QD,51,22,29,21
L4  1QF,L4,1QF,33,13,20,16
L4  1QG,L4,1QG,23,10,13,6
L4  1QH,L4,1QH,48,22,26,26
L4  1QL,L4,1QL,12,7,5,6
L4  1QP,L4,1QP,11,5,6,3
L4  1QQ,L4,1QQ,26,13,13,11
L4  1QU,L4,1QU,90,41,49,39
L4  1QW,L4,1QW,7,4,3,4
L4  1QY,L4,1QY,70,29,41,39
L4  1RA,L4,1RA,28,10,18,14
L4  1RB,L4,1RB,35,20,15,15
L4  1RD,L4,1RD,33,16,17,21
L4  1RE,L4,1RE,50,29,21,18
L4  1RG,L4,1RG,83,41,42,41
L4  1RJ,L4,1RJ,83,41,42,36
L4  1RL,L4,1RL,85,49,36,35
L4  1RN,L4,1RN,11,5,6,8
L4  1RP,L4,1RP,39,21,18,17
L4  1RQ,L4,1RQ,54,21,33,23
L4  1RR,L4,1RR,30,15,15,17
L4  1RS,L4,1RS,79,43,36,36
L4  1RW,L4,1RW,38,14,24,17
L4  1SD,L4,1SD,33,13,20,15
L4  1SH,L4,1SH,14,7,7,11
L4  1SL,L4,1SL,3,2,1,1
L4  1SN,L4,1SN,21,10,11,11
L4  1SR,L4,1SR,44,21,23,19
L4  1TB,L4,1TB,4,1,3,1
L4  1TH,L4,1TH,22,15,7,8
L4  1TS,L4,1TS,114,53,61,44
L4  1TT,L4,1TT,5,2,3,3
L4  1TU,L4,1TU,15,7,8,8
L4  1UB,L4,1UB,15,13,2,6
L4  1UH,L4,1UH,75,37,38,38
L4  1UJ,L4,1UJ,29,16,13,15
L4  1UL,L4,1UL,93,47,46,47
L4  1UU,L4,1UU,15,8,7,6
L4  1UX,L4,1UX,13,6,7,6
L4  1UY,L4,1UY,21,9,12,9
L4  1UZ,L4,1UZ,134,65,69,54
L4  1XA,L4,1XA,76,48,28,50
L4  1XB,L4,1XB,25,10,15,15
L4  1XD,L4,1XD,102,69,33,79
L4  1XE,L4,1XE,37,25,12,22
L4  1XF,L4,1XF,43,22,21,19
L4  1XG,L4,1XG,41,19,22,9
L4  1XJ,L4,1XJ,160,83,77,65
L4  1XL,L4,1XL,64,33,31,24
L4  1XN,L4,1XN,69,43,26,37
L4  1XP,L4,1XP,54,29,25,24
L4  1XQ,L4,1XQ,29,11,18,13
L4  1XR,L4,1XR,39,17,22,16
L4  1XS,L4,1XS,50,22,28,20
L4  1XT,L4,1XT,43,21,22,19
L4  1XU,L4,1XU,39,18,21,17
L4  1XW,L4,1XW,37,18,19,17
L4  1XX,L4,1XX,42,15,27,22
L4  1XY,L4,1XY,21,8,13,8
L4  1XZ,L4,1XZ,12,5,7,5
L4  1YA,L4,1YA,36,18,18,32
L4  1YB,L4,1YB,88,43,45,42
L4  1YD,L4,1YD,60,25,35,26
L4  1YE,L4,1YE,24,13,11,15
L4  1YF,L4,1YF,64,29,35,25
L4  1YG,L4,1YG,7,4,3,4
L4  1YH,L4,1YH,32,16,16,13
L4  1YQ,L4,1YQ,19,8,11,8
L4  2PA,L4,2PA,12,5,7,8
L4  2QA,L4,2QA,26,15,11,20
L4  2QB,L4,2QB,35,23,12,23
L4  2QD,L4,2QD,10,4,6,7
L4  2QE,L4,2QE,54,26,28,20
L4  2QF,L4,2QF,46,29,17,25
L4  2QG,L4,2QG,73,36,37,36
L4  2QH,L4,2QH,49,25,24,28
L4  2QL,L4,2QL,53,24,29,30
L4  2QN,L4,2QN,53,29,24,27
L4  2QP,L4,2QP,20,11,9,15
L4  2QR,L4,2QR,70,34,36,27
L4  2QS,L4,2QS,21,12,9,11
L4  2QW,L4,2QW,48,23,25,29
L4  2QX,L4,2QX,18,12,6,13
L4  2QZ,L4,2QZ,32,21,11,20
L4  2RB,L4,2RB,26,15,11,14
L4  2RD,L4,2RD,15,12,3,9
L4  2RE,L4,2RE,36,18,18,22
L4  2RF,L4,2RF,63,32,31,30
L4  2RG,L4,2RG,33,17,16,16
L4  2RH,L4,2RH,49,23,26,25
L4  2RJ,L4,2RJ,83,31,52,31
L4  2RL,L4,2RL,77,53,24,39
L4  2RN,L4,2RN,48,32,16,34
L4  2RP,L4,2RP,9,8,1,6
L4  2RQ,L4,2RQ,70,31,39,26
L4  2RS,L4,2RS,62,30,32,27
L4  2RT,L4,2RT,28,14,14,15
L4  2RW,L4,2RW,37,22,15,15
L4  2RX,L4,2RX,14,7,7,8
L4  2RY,L4,2RY,7,4,3,3
L4  2RZ,L4,2RZ,13,10,3,8
L4  2SA,L4,2SA,103,51,52,40
L4  2SB,L4,2SB,116,56,60,42
L4  2SD,L4,2SD,102,51,51,45
L4  2SE,L4,2SE,51,28,23,19
L4  2SG,L4,2SG,29,17,12,16
L4  2SH,L4,2SH,35,15,20,16
L4  2SJ,L4,2SJ,36,18,18,15
L4  2SN,L4,2SN,34,18,16,16
L4  2SP,L4,2SP,130,64,66,47
L4  2SR,L4,2SR,70,29,41,35
L4  2SS,L4,2SS,50,23,27,18
L4  2ST,L4,2ST,85,39,46,33
L4  2SU,L4,2SU,75,34,41,37
L4  2SW,L4,2SW,46,21,25,19
L4  2SX,L4,2SX,92,42,50,33
L4  2SY,L4,2SY,93,37,56,41
L4  2SZ,L4,2SZ,47,23,24,20
L4  2TA,L4,2TA,45,27,18,31
L4  2TB,L4,2TB,97,43,54,38
L4  2TD,L4,2TD,77,35,42,28
L4  2TE,L4,2TE,82,37,45,35
L4  2TF,L4,2TF,57,25,32,24
L4  2TG,L4,2TG,87,42,45,35
L4  2TH,L4,2TH,36,13,23,23
L4  2TJ,L4,2TJ,37,20,17,23
L4  2TL,L4,2TL,55,20,35,24
L4  2TN,L4,2TN,107,52,55,49
L4  2TP,L4,2TP,112,50,62,42
L4  2TQ,L4,2TQ,111,55,56,44
L4  2TR,L4,2TR,98,49,49,35
L4  2TS,L4,2TS,122,53,69,36
L4  2TT,L4,2TT,101,43,58,36
L4  2TU,L4,2TU,58,26,32,26
L4  2TW,L4,2TW,81,34,47,29
L4  2TX,L4,2TX,62,31,31,23
L4  2TY,L4,2TY,57,20,37,22
L4  2TZ,L4,2TZ,18,7,11,9
L4  2UA,L4,2UA,36,24,12,25
L4  2UB,L4,2UB,90,51,39,32
L4  2UD,L4,2UD,49,17,32,18
L4  2UE,L4,2UE,92,41,51,30
L4  2UF,L4,2UF,98,40,58,37
L4  2UG,L4,2UG,63,34,29,42
L4  2UH,L4,2UH,116,42,74,45
L4  2UJ,L4,2UJ,79,31,48,32
L4  2UL,L4,2UL,74,32,42,29
L4  2UN,L4,2UN,122,66,56,49
L4  2UP,L4,2UP,105,39,66,41
L4  2UQ,L4,2UQ,54,24,30,30
L4  2UR,L4,2UR,54,29,25,32
L4  2US,L4,2US,64,25,39,31
L4  2UT,L4,2UT,48,22,26,32
L4  2UU,L4,2UU,113,51,62,44
L4  2UW,L4,2UW,67,37,30,30
L4  2UX,L4,2UX,78,37,41,29
L4  2UY,L4,2UY,81,33,48,36
L4  2UZ,L4,2UZ,59,27,32,28
L4  2XA,L4,2XA,27,14,13,11
L4  2XB,L4,2XB,19,13,6,9
L4  2XD,L4,2XD,13,8,5,6
L4  2XE,L4,2XE,60,30,30,34
L4  2XF,L4,2XF,51,29,22,33
L4  2XG,L4,2XG,40,15,25,26
L4  3QD,L4,3QD,10,6,4,4
L4  3QF,L4,3QF,18,10,8,16
L4  3QH,L4,3QH,3,2,1,2
L4  3QL,L4,3QL,18,13,5,13
L4  3QP,L4,3QP,32,18,14,16
L4  3QS,L4,3QS,64,29,35,20
L4  3QT,L4,3QT,64,25,39,21
L4  3QU,L4,3QU,33,19,14,12
L4  3QW,L4,3QW,2,1,1,2
L4  3QX,L4,3QX,50,22,28,34
L4  3QY,L4,3QY,45,23,22,25
L4  3QZ,L4,3QZ,23,12,11,10
L4  3RA,L4,3RA,53,29,24,24
L4  3RB,L4,3RB,47,21,26,22
L4  3RD,L4,3RD,14,8,6,11
L4  3RE,L4,3RE,70,32,38,28
L4  3RF,L4,3RF,84,43,41,30
L4  3RG,L4,3RG,92,41,51,34
L4  3RH,L4,3RH,19,10,9,12
L4  3RJ,L4,3RJ,43,20,23,15
L4  3RL,L4,3RL,53,23,30,18
L4  3RN,L4,3RN,25,14,11,10
L4  3RP,L4,3RP,87,38,49,34
L4  3RQ,L4,3RQ,85,45,40,37
L4  3RR,L4,3RR,99,48,51,44
L4  3RS,L4,3RS,131,68,63,54
L4  3RT,L4,3RT,59,27,32,24
L4  3RU,L4,3RU,46,24,22,19
L4  3RW,L4,3RW,68,31,37,25
L4  3RX,L4,3RX,91,45,46,35
L4  3RY,L4,3RY,106,54,52,42
L4  3RZ,L4,3RZ,92,44,48,40
L4  3SA,L4,3SA,110,50,60,39
L4  3SB,L4,3SB,91,40,51,40
L4  3SD,L4,3SD,113,52,61,41
L4  3SE,L4,3SE,9,3,6,4
L4  3SF,L4,3SF,34,14,20,21
L4  3SG,L4,3SG,92,43,49,43
L4  3SH,L4,3SH,83,35,48,47
L4  3SJ,L4,3SJ,105,48,57,51
L4  3SL,L4,3SL,104,51,53,44
L4  3SN,L4,3SN,49,20,29,32
L4  3SQ,L4,3SQ,99,49,50,46
L4  3SR,L4,3SR,34,17,17,18
L4  3SS,L4,3SS,101,45,56,50
L4  3ST,L4,3ST,100,59,41,42
L4  3SU,L4,3SU,60,28,32,24
L4  3SW,L4,3SW,28,12,16,15
L4  3SX,L4,3SX,121,56,65,47
L4  3SY,L4,3SY,96,41,55,48
L4  3SZ,L4,3SZ,69,31,38,36
L4  3TA,L4,3TA,43,22,21,22
L4  3TB,L4,3TB,64,28,36,35
L4  3TD,L4,3TD,18,11,7,10
L4  3TE,L4,3TE,4,3,1,2
L4  3TF,L4,3TF,11,8,3,10
L4  3TL,L4,3TL,59,33,26,27
L4  3TN,L4,3TN,86,37,49,36
L4  3TQ,L4,3TQ,29,15,14,15
L4  3TS,L4,3TS,48,24,24,21
L4  3TT,L4,3TT,21,5,16,10
L4  3TW,L4,3TW,80,36,44,36
L4  3TY,L4,3TY,19,10,9,8
L4  3UA,L4,3UA,28,14,14,17
L4  3UF,L4,3UF,38,21,17,20
L4  4AD,L4,4AD,24,14,10,13
L4  4AF,L4,4AF,14,11,3,10
L4  4AH,L4,4AH,4,4,0,3
L4  4AJ,L4,4AJ,14,8,6,12
L4  4AU,L4,4AU,27,11,16,11
L4  4AY,L4,4AY,8,5,3,5
L4  4BB,L4,4BB,3,3,0,3
L4  4BE,L4,4BE,7,5,2,6
L4  4BL,L4,4BL,22,13,9,16
L4  4BU,L4,4BU,105,51,54,33
L4  4BZ,L4,4BZ,2,0,2,1
L4  4DE,L4,4DE,82,40,42,39
L4  4DF,L4,4DF,26,20,6,20
L4  4DG,L4,4DG,78,40,38,39
L4  4DH,L4,4DH,80,38,42,39
L4  4DJ,L4,4DJ,79,35,44,43
L4  4DL,L4,4DL,77,37,40,49
L4  4DN,L4,4DN,77,36,41,36
L4  4DP,L4,4DP,79,41,38,39
L4  4DQ,L4,4DQ,87,40,47,40
L4  4DR,L4,4DR,69,29,40,38
L4  4DS,L4,4DS,68,27,41,36
L4  4DT,L4,4DT,72,43,29,33
L4  4DU,L4,4DU,53,26,27,37
L4  4DW,L4,4DW,73,38,35,39
L4  4DX,L4,4DX,50,28,22,36
L4  4DY,L4,4DY,57,29,28,34
L4  4DZ,L4,4DZ,63,38,25,38
L4  4EA,L4,4EA,62,31,31,39
L4  4EB,L4,4EB,51,28,23,33
L4  4ED,L4,4ED,23,10,13,12
L4  4EE,L4,4EE,58,29,29,38
L4  4EF,L4,4EF,60,24,36,37
L4  4EG,L4,4EG,49,22,27,32
L4  4EH,L4,4EH,10,9,1,9
L4  4EJ,L4,4EJ,17,10,7,6
L4  4EN,L4,4EN,39,17,22,26
L4  4EP,L4,4EP,58,31,27,33
L4  4EQ,L4,4EQ,55,26,29,35
L4  4ER,L4,4ER,55,30,25,23
L4  4EW,L4,4EW,63,32,31,36
L4  4EX,L4,4EX,16,7,9,7
L4  4HB,L4,4HB,13,7,6,13
L4  4HE,L4,4HE,34,24,10,26
L4  4HH,L4,4HH,16,8,8,9
L4  4HP,L4,4HP,95,47,48,44
L4  4HQ,L4,4HQ,44,27,17,28
L4  4HS,L4,4HS,94,41,53,42
L4  4HT,L4,4HT,67,34,33,39
L4  4HU,L4,4HU,55,20,35,28
L4  4HY,L4,4HY,100,58,42,53
L4  4JS,L4,4JS,25,13,12,16
L4  4JT,L4,4JT,27,14,13,10
L4  4JX,L4,4JX,53,32,21,35
L4  4LE,L4,4LE,8,6,2,5
L4  4LF,L4,4LF,34,15,19,16
L4  4LG,L4,4LG,78,40,38,28
L4  4LR,L4,4LR,23,17,6,14
L4  4LS,L4,4LS,9,6,3,6
L4  4LT,L4,4LT,7,4,3,4
L4  4LW,L4,4LW,36,23,13,23
L4  4LZ,L4,4LZ,51,28,23,24
L4  4ND,L4,4ND,19,8,11,13
L4  4NE,L4,4NE,44,20,24,16
L4  4NF,L4,4NF,33,18,15,15
L4  4NH,L4,4NH,35,16,19,18
L4  4NJ,L4,4NJ,15,7,8,9
L4  4NL,L4,4NL,25,18,7,16
L4  4NU,L4,4NU,26,11,15,15
L4  4PD,L4,4PD,7,3,4,4
L4  4PG,L4,4PG,3,2,1,2
L4  4PH,L4,4PH,9,3,6,6
L4  4PJ,L4,4PJ,64,36,28,41
L4  4PN,L4,4PN,22,18,4,17
L4  4PR,L4,4PR,60,30,30,23
L4  4PS,L4,4PS,38,14,24,17
L4  4PT,L4,4PT,15,8,7,13
L4  4PU,L4,4PU,53,28,25,30
L4  4PW,L4,4PW,54,33,21,25
L4  4PX,L4,4PX,14,5,9,8
L4  4PY,L4,4PY,4,4,0,4
L4  4PZ,L4,4PZ,33,25,8,28
L4  4QB,L4,4QB,136,70,66,62
L4  4QD,L4,4QD,49,28,21,23
L4  4QE,L4,4QE,38,20,18,25
L4  4QG,L4,4QG,34,15,19,22
L4  4QH,L4,4QH,12,8,4,11
L4  4QJ,L4,4QJ,37,16,21,23
L4  4QL,L4,4QL,7,3,4,7
L4  4QN,L4,4QN,44,19,25,23
L4  4QP,L4,4QP,70,29,41,35
L4  4QQ,L4,4QQ,92,45,47,43
L4  4QR,L4,4QR,13,5,8,6
L4  4QT,L4,4QT,13,6,7,5
L4  4QU,L4,4QU,28,18,10,13
L4  4QW,L4,4QW,30,13,17,12
L4  4QX,L4,4QX,37,23,14,16
L4  4QY,L4,4QY,37,18,19,15
L4  4QZ,L4,4QZ,77,32,45,32
L4  4RB,L4,4RB,1,1,0,1
L4  5PB,L4,5PB,13,10,3,10
L4  5PE,L4,5PE,9,7,2,8
L4  5PH,L4,5PH,7,5,2,5
L4  5PP,L4,5PP,63,31,32,26
L4  5PQ,L4,5PQ,5,4,1,4
L4  5PR,L4,5PR,91,43,48,40
L4  5PS,L4,5PS,73,38,35,32
L4  5PT,L4,5PT,84,40,44,38
L4  5PU,L4,5PU,37,18,19,16
L4  5PW,L4,5PW,15,5,10,7
L4  5PZ,L4,5PZ,69,36,33,27
L4  5QA,L4,5QA,84,41,43,44
L4  5QB,L4,5QB,5,3,2,3
L4  5QD,L4,5QD,14,6,8,6
L4  5QE,L4,5QE,77,42,35,31
L4  5QF,L4,5QF,46,20,26,21
L4  5QG,L4,5QG,69,33,36,31
L4  5QH,L4,5QH,12,4,8,7
L4  5QJ,L4,5QJ,15,8,7,6
L4  5QL,L4,5QL,11,4,7,7
L4  5QN,L4,5QN,110,57,53,57
L4  5QP,L4,5QP,85,42,43,32
L4  5QQ,L4,5QQ,39,14,25,23
L4  5QR,L4,5QR,74,34,40,26
L4  5QS,L4,5QS,66,33,33,29
L4  5QT,L4,5QT,33,14,19,16
L4  5QU,L4,5QU,103,51,52,34
L4  5QW,L4,5QW,87,45,42,41
L4  5QX,L4,5QX,34,17,17,15
L4  5QY,L4,5QY,77,34,43,35
L4  5RA,L4,5RA,19,11,8,16
L4  5RB,L4,5RB,27,12,15,16
L4  5RD,L4,5RD,22,12,10,13
L4  5RE,L4,5RE,101,53,48,43
L4  5RF,L4,5RF,33,16,17,14
L4  5RJ,L4,5RJ,62,30,32,31
L4  5RL,L4,5RL,78,34,44,33
L4  5RN,L4,5RN,57,27,30,28
L4  5RP,L4,5RP,33,20,13,16
L4  5RQ,L4,5RQ,1,1,0,1
L4  5RR,L4,5RR,92,52,40,49
L4  5RS,L4,5RS,34,22,12,16
L4  5RT,L4,5RT,18,12,6,11
L4  5RU,L4,5RU,13,6,7,7
L4  5RW,L4,5RW,90,37,53,43
L4  5RX,L4,5RX,79,33,46,35
L4  5SB,L4,5SB,71,32,39,36
L4  5SD,L4,5SD,84,36,48,34
L4  5SG,L4,5SG,85,46,39,52
L4  5SH,L4,5SH,77,36,41,40
L4  5SJ,L4,5SJ,64,31,33,34
L4  5SL,L4,5SL,52,26,26,25
L4  5SN,L4,5SN,55,27,28,28
L4  5SP,L4,5SP,41,19,22,23
L4  5SQ,L4,5SQ,77,41,36,43
L4  5SR,L4,5SR,35,17,18,17
L4  5SS,L4,5SS,39,19,20,16
L4  5ST,L4,5ST,41,21,20,22
L4  5SU,L4,5SU,42,18,24,20
L4  5SW,L4,5SW,90,44,46,36
L4  5SX,L4,5SX,42,20,22,21
L4  5SY,L4,5SY,62,25,37,34
L4  5SZ,L4,5SZ,70,30,40,29
L4  5TA,L4,5TA,45,20,25,23
L4  5TB,L4,5TB,27,14,13,19
L4  5TD,L4,5TD,83,44,39,49
L4  5TE,L4,5TE,38,25,13,27
L4  5TF,L4,5TF,34,22,12,21
L4  5TG,L4,5TG,85,40,45,33
L4  5TH,L4,5TH,52,24,28,18
L4  5TJ,L4,5TJ,56,29,27,26
L4  5TL,L4,5TL,89,43,46,37
L4  5TN,L4,5TN,60,24,36,31
L4  5TP,L4,5TP,68,34,34,28
L4  5TQ,L4,5TQ,97,40,57,38
L4  5TR,L4,5TR,75,38,37,26
L4  5TS,L4,5TS,39,14,25,18
L4  5TT,L4,5TT,77,35,42,36
L4  5TU,L4,5TU,57,26,31,25
L4  5TW,L4,5TW,54,16,38,22
L4  5TX,L4,5TX,77,38,39,39
L4  5TY,L4,5TY,59,27,32,26
L4  5TZ,L4,5TZ,72,30,42,28
L4  5UA,L4,5UA,62,32,30,25
L4  5UB,L4,5UB,23,15,8,15
L4  5UD,L4,5UD,52,28,24,26
L4  5UE,L4,5UE,94,39,55,38
L4  5UF,L4,5UF,92,50,42,39
L4  5UG,L4,5UG,50,25,25,28
L4  5UH,L4,5UH,30,16,14,15
L4  5UJ,L4,5UJ,23,8,15,15
L4  5UL,L4,5UL,25,12,13,12
L4  5UN,L4,5UN,41,21,20,25
L4  5UQ,L4,5UQ,59,35,24,33
L4  5UR,L4,5UR,22,14,8,9
L4  5US,L4,5US,59,28,31,33
L4  5UT,L4,5UT,98,44,54,41
L4  5UU,L4,5UU,25,12,13,14
L4  5UW,L4,5UW,31,15,16,15
L4  5UX,L4,5UX,148,66,82,57
L4  5UY,L4,5UY,72,31,41,34
L4  5UZ,L4,5UZ,61,31,30,34
L4  5XA,L4,5XA,70,32,38,45
L4  5XB,L4,5XB,59,27,32,37
L4  5XD,L4,5XD,39,16,23,25
L4  5XE,L4,5XE,22,12,10,14
L4  5XJ,L4,5XJ,15,12,3,11
L4  5XL,L4,5XL,77,34,43,40
L4  5XN,L4,5XN,51,22,29,28
L4  5XW,L4,5XW,16,13,3,13
L4  6BA,L4,6BA,53,26,27,42
L4  6SB,L4,6SB,72,34,38,30
L4  6SF,L4,6SF,46,26,20,17
L4  6SG,L4,6SG,69,39,30,31
L4  6SH,L4,6SH,70,35,35,23
L4  6SJ,L4,6SJ,91,44,47,32
L4  6SQ,L4,6SQ,79,38,41,35
L4  6SR,L4,6SR,42,22,20,15
L4  6SS,L4,6SS,79,37,42,34
L4  6ST,L4,6ST,51,21,30,23
L4  6SU,L4,6SU,90,40,50,34
L4  6SX,L4,6SX,36,12,24,16
L4  6SY,L4,6SY,73,36,37,32
L4  6SZ,L4,6SZ,84,46,38,34
L4  6TA,L4,6TA,85,49,36,35
L4  6TB,L4,6TB,31,12,19,12
L4  6TE,L4,6TE,78,36,42,34
L4  6TF,L4,6TF,77,35,42,35
L4  6TG,L4,6TG,32,17,15,16
L4  6TH,L4,6TH,36,13,23,14
L4  6TJ,L4,6TJ,46,25,21,21
L4  6TL,L4,6TL,38,19,19,17
L4  6TN,L4,6TN,33,16,17,22
L4  6TP,L4,6TP,59,32,27,36
L4  6TQ,L4,6TQ,13,8,5,8
L4  6TR,L4,6TR,41,23,18,25
L4  6TS,L4,6TS,25,15,10,16
L4  6TT,L4,6TT,29,14,15,12
L4  6TU,L4,6TU,1,1,0,1
L4  6TW,L4,6TW,23,13,10,13
L4  6TX,L4,6TX,99,44,55,45
L4  6TY,L4,6TY,94,48,46,42
L4  6TZ,L4,6TZ,73,35,38,30
L4  6UA,L4,6UA,50,22,28,21
L4  6UB,L4,6UB,11,6,5,7
L4  6UD,L4,6UD,36,20,16,13
L4  6UF,L4,6UF,33,15,18,13
L4  6UG,L4,6UG,24,11,13,12
L4  6UH,L4,6UH,19,8,11,9
L4  6UL,L4,6UL,53,21,32,21
L4  6UP,L4,6UP,49,26,23,23
L4  6UQ,L4,6UQ,28,13,15,14
L4  6UR,L4,6UR,34,21,13,26
L4  6US,L4,6US,39,25,14,32
L4  6UT,L4,6UT,33,13,20,14
L4  6UU,L4,6UU,19,6,13,11
L4  6UY,L4,6UY,44,26,18,16
L4  6XA,L4,6XA,61,31,30,27
L4  6XD,L4,6XD,54,30,24,25
L4  6XG,L4,6XG,24,8,16,13
L4  6XH,L4,6XH,45,18,27,21
L4  6XP,L4,6XP,47,17,30,43
L4  6XQ,L4,6XQ,14,9,5,11
L4  6XR,L4,6XR,49,23,26,22
L4  6XW,L4,6XW,49,14,35,44
L4  7TA,L4,7TA,57,29,28,29
L4  7TB,L4,7TB,13,6,7,7
L4  7TD,L4,7TD,68,37,31,25
L4  7TE,L4,7TE,80,34,46,34
L4  7TF,L4,7TF,64,30,34,25
L4  7TG,L4,7TG,87,40,47,31
L4  7TH,L4,7TH,40,16,24,18
L4  7TJ,L4,7TJ,89,44,45,34
L4  7TL,L4,7TL,84,40,44,38
L4  7TN,L4,7TN,44,16,28,18
L4  7TP,L4,7TP,110,53,57,38
L4  7TQ,L4,7TQ,49,27,22,24
L4  7TR,L4,7TR,22,10,12,11
L4  7TS,L4,7TS,101,52,49,35
L4  7TT,L4,7TT,63,30,33,22
L4  7TU,L4,7TU,61,31,30,36
L4  7TW,L4,7TW,92,41,51,34
L4  7TX,L4,7TX,27,13,14,10
L4  7TY,L4,7TY,62,27,35,25
L4  7TZ,L4,7TZ,33,15,18,18
L4  7UA,L4,7UA,29,13,16,11
L4  7UB,L4,7UB,98,45,53,37
L4  7UD,L4,7UD,41,17,24,17
L4  7UE,L4,7UE,36,25,11,23
L4  7UF,L4,7UF,28,11,17,15
L4  7UG,L4,7UG,73,34,39,29
L4  7UH,L4,7UH,67,27,40,24
L4  7UJ,L4,7UJ,58,27,31,24
L4  7UL,L4,7UL,14,7,7,4
L4  7UN,L4,7UN,58,33,25,25
L4  7UP,L4,7UP,47,23,24,21
L4  7UQ,L4,7UQ,31,17,14,22
L4  7UR,L4,7UR,70,38,32,41
L4  7US,L4,7US,108,44,64,48
L4  7UT,L4,7UT,88,41,47,38
L4  7UU,L4,7UU,80,35,45,36
L4  7UW,L4,7UW,9,2,7,8
L4  7UX,L4,7UX,92,37,55,39
L4  7UY,L4,7UY,115,54,61,41
L4  7UZ,L4,7UZ,38,21,17,20
L4  7XA,L4,7XA,45,20,25,18
L4  7XB,L4,7XB,61,31,30,26
L4  7XD,L4,7XD,123,51,72,45
L4  7XE,L4,7XE,74,38,36,31
L4  7XF,L4,7XF,66,29,37,27
L4  7XG,L4,7XG,95,50,45,43
L4  7XH,L4,7XH,88,43,45,35
L4  7XJ,L4,7XJ,140,71,69,52
L4  7XL,L4,7XL,58,34,24,24
L4  7XN,L4,7XN,45,19,26,21
L4  7XP,L4,7XP,42,29,13,38
L4  7XQ,L4,7XQ,51,24,27,25
L4  7XR,L4,7XR,57,33,24,48
L4  7XS,L4,7XS,61,32,29,51
L4  7XT,L4,7XT,39,17,22,39
L4  7XW,L4,7XW,59,30,29,27
L4  8RT,L4,8RT,3,2,1,2
L4  8RU,L4,8RU,22,10,12,9
L4  8RX,L4,8RX,25,13,12,11
L4  8RY,L4,8RY,36,20,16,14
L4  8RZ,L4,8RZ,33,18,15,14
L4  8SA,L4,8SA,94,44,50,41
L4  8SB,L4,8SB,63,26,37,24
L4  8SE,L4,8SE,70,47,23,54
L4  8SG,L4,8SG,62,32,30,35
L4  8SH,L4,8SH,68,29,39,28
L4  8SJ,L4,8SJ,80,38,42,32
L4  8SL,L4,8SL,86,34,52,32
L4  8SN,L4,8SN,81,39,42,30
L4  8SP,L4,8SP,54,26,28,22
L4  8SR,L4,8SR,76,39,37,34
L4  8SS,L4,8SS,80,41,39,30
L4  8ST,L4,8ST,80,36,44,46
L4  8SW,L4,8SW,4,1,3,2
L4  8SX,L4,8SX,52,23,29,22
L4  8SY,L4,8SY,67,27,40,28
L4  8TA,L4,8TA,26,15,11,10
L4  8TB,L4,8TB,86,40,46,35
L4  8TD,L4,8TD,70,35,35,20
L4  8TE,L4,8TE,132,60,72,52
L4  8TF,L4,8TF,87,42,45,38
L4  8TH,L4,8TH,55,24,31,20
L4  8TJ,L4,8TJ,35,18,17,15
L4  8TL,L4,8TL,47,22,25,17
L4  8TN,L4,8TN,77,41,36,32
L4  8TP,L4,8TP,19,9,10,8
L4  8TQ,L4,8TQ,37,15,22,16
L4  8TR,L4,8TR,18,9,9,6
L4  8TS,L4,8TS,31,13,18,16
L4  8TT,L4,8TT,48,22,26,24
L4  8TU,L4,8TU,22,13,9,16
L4  8TW,L4,8TW,43,20,23,18
L4  8TX,L4,8TX,27,9,18,12
L4  8TY,L4,8TY,74,31,43,36
L4  8UA,L4,8UA,59,29,30,28
L4  8UB,L4,8UB,80,37,43,31
L4  8UD,L4,8UD,73,32,41,22
L4  8UE,L4,8UE,58,29,29,21
L4  8UF,L4,8UF,22,11,11,11
L4  8UG,L4,8UG,74,34,40,36
L4  8UH,L4,8UH,35,17,18,16
L4  8UJ,L4,8UJ,35,16,19,11
L4  8UL,L4,8UL,17,7,10,7
L4  8UN,L4,8UN,59,32,27,25
L4  8UP,L4,8UP,45,21,24,16
L4  8UQ,L4,8UQ,52,22,30,25
L4  8UR,L4,8UR,101,49,52,33
L4  8US,L4,8US,60,29,31,26
L4  8UW,L4,8UW,43,23,20,20
L4  8UX,L4,8UX,15,6,9,6
L4  8UY,L4,8UY,76,41,35,61
L4  9RB,L4,9RB,81,39,42,39
L4  9RD,L4,9RD,86,41,45,31
L4  9RE,L4,9RE,84,37,47,29
L4  9RF,L4,9RF,57,17,40,26
L4  9RG,L4,9RG,94,34,60,43
L4  9RH,L4,9RH,39,17,22,14
L4  9RJ,L4,9RJ,109,48,61,39
L4  9RL,L4,9RL,102,33,69,41
L4  9RN,L4,9RN,60,25,35,24
L4  9RP,L4,9RP,21,4,17,12
L4  9RQ,L4,9RQ,110,58,52,33
L4  9RR,L4,9RR,86,32,54,35
L4  9RS,L4,9RS,68,25,43,19
L4  9RT,L4,9RT,97,44,53,34
L4  9RU,L4,9RU,96,38,58,36
L4  9RW,L4,9RW,67,29,38,28
L4  9RX,L4,9RX,132,48,84,49
L4  9RZ,L4,9RZ,13,9,4,10
L4  9SA,L4,9SA,6,4,2,6
L4  9SB,L4,9SB,37,16,21,15
L4  9SD,L4,9SD,42,16,26,20
L4  9SE,L4,9SE,64,29,35,28
L4  9SF,L4,9SF,50,23,27,19
L4  9SJ,L4,9SJ,88,39,49,41
L4  9SL,L4,9SL,122,66,56,48
L4  9SN,L4,9SN,90,43,47,40
L4  9SP,L4,9SP,95,43,52,42
L4  9SR,L4,9SR,107,48,59,45
L4  9SS,L4,9SS,73,28,45,31
L4  9ST,L4,9ST,100,43,57,43
L4  9SU,L4,9SU,35,22,13,14
L4  9SW,L4,9SW,96,50,46,41
L4  9SX,L4,9SX,34,16,18,19
L4  9SY,L4,9SY,70,36,34,23
L4  9SZ,L4,9SZ,91,43,48,34
L4  9TA,L4,9TA,68,31,37,27
L4  9TB,L4,9TB,62,30,32,26
L4  9TD,L4,9TD,80,35,45,39
L4  9TE,L4,9TE,81,34,47,32
L4  9TF,L4,9TF,81,36,45,30
L4  9TG,L4,9TG,86,41,45,33
L4  9TH,L4,9TH,27,13,14,19
L4  9TJ,L4,9TJ,74,34,40,32
L4  9TL,L4,9TL,49,24,25,19
L4  9TN,L4,9TN,25,14,11,13
L4  9TP,L4,9TP,48,19,29,20
L4  9TQ,L4,9TQ,83,38,45,34
L4  9TR,L4,9TR,83,34,49,38
L4  9TS,L4,9TS,122,65,57,42
L4  9TT,L4,9TT,29,16,13,10
L4  9TU,L4,9TU,93,41,52,36
L4  9TW,L4,9TW,41,18,23,18
L4  9TX,L4,9TX,61,34,27,23
L4  9TY,L4,9TY,47,17,30,21
L4  9TZ,L4,9TZ,57,23,34,24
L4  9UA,L4,9UA,107,43,64,46
L4  9UD,L4,9UD,67,31,36,28
L4  9UE,L4,9UE,50,19,31,25
L4  9UF,L4,9UF,47,26,21,19
L4  9UG,L4,9UG,44,23,21,19
L4  9UH,L4,9UH,26,12,14,10
L4  9UJ,L4,9UJ,82,35,47,33
L4  9UL,L4,9UL,38,16,22,17
L4  9UN,L4,9UN,47,21,26,19
L4  9UP,L4,9UP,121,58,63,44
L4  9UQ,L4,9UQ,86,41,45,38
L4  9UR,L4,9UR,80,43,37,28
L4  9US,L4,9US,94,49,45,38
L4  9UT,L4,9UT,87,43,44,40
L4  9UU,L4,9UU,11,5,6,4
L4  9UW,L4,9UW,83,34,49,31
L4  9UY,L4,9UY,49,30,19,46
L4  9UZ,L4,9UZ,74,46,28,52
L4  9XB,L4,9XB,93,64,29,75
L4  9XD,L4,9XD,8,8,0,6
L4  9XS,L4,9XS,67,27,40,36
L4  9XT,L4,9XT,55,23,32,34
L4  9XX,L4,9XX,33,16,17,15
L4  9XY,L4,9XY,79,38,41,29
L40 0RA,L40,0RA,70,37,33,27
L40 0RB,L40,0RB,28,12,16,12
L40 0RD,L40,0RD,58,28,30,27
L40 0RE,L40,0RE,32,16,16,11
L40 0RF,L40,0RF,10,5,5,4
L40 0RG,L40,0RG,67,33,34,25
L40 0RH,L40,0RH,35,15,20,16
L40 0RJ,L40,0RJ,30,18,12,12
L40 0RL,L40,0RL,11,8,3,7
L40 0RN,L40,0RN,52,28,24,22
L40 0RP,L40,0RP,28,13,15,11
L40 0RQ,L40,0RQ,87,45,42,37
L40 0RR,L40,0RR,24,12,12,16
L40 0RS,L40,0RS,7,3,4,3
L40 0RT,L40,0RT,54,26,28,24
L40 0RU,L40,0RU,5,3,2,2
L40 0RW,L40,0RW,48,22,26,18
L40 0RX,L40,0RX,62,32,30,30
L40 0RY,L40,0RY,56,28,28,25
L40 0SA,L40,0SA,15,10,5,10
L40 0SD,L40,0SD,67,34,33,37
L40 0SG,L40,0SG,98,52,46,39
L40 0SJ,L40,0SJ,3,1,2,2
L40 0SN,L40,0SN,103,50,53,50
L40 0SP,L40,0SP,17,7,10,8
L40 0SQ,L40,0SQ,93,47,46,40
L40 0SR,L40,0SR,22,10,12,10
L40 0SS,L40,0SS,50,32,18,19
L40 0ST,L40,0ST,30,14,16,11
L40 0SU,L40,0SU,14,6,8,8
L40 0TA,L40,0TA,6,2,4,2
L40 0TF,L40,0TF,11,6,5,3
L40 0TL,L40,0TL,4,2,2,2
L40 0TQ,L40,0TQ,32,10,22,21
L40 0TW,L40,0TW,15,10,5,6
L40 1BB,L40,1BB,23,10,13,9
L40 1BJ,L40,1BJ,5,2,3,3
L40 1RZ,L40,1RZ,11,6,5,4
L40 1SA,L40,1SA,54,24,30,25
L40 1SB,L40,1SB,37,18,19,17
L40 1SD,L40,1SD,52,29,23,22
L40 1SE,L40,1SE,16,10,6,6
L40 1SF,L40,1SF,14,8,6,5
L40 1SG,L40,1SG,4,2,2,2
L40 1SH,L40,1SH,36,21,15,16
L40 1SJ,L40,1SJ,40,24,16,13
L40 1SL,L40,1SL,32,14,18,14
L40 1SN,L40,1SN,26,12,14,11
L40 1SP,L40,1SP,8,3,5,4
L40 1SQ,L40,1SQ,47,21,26,18
L40 1SR,L40,1SR,26,12,14,15
L40 1SS,L40,1SS,12,8,4,4
L40 1ST,L40,1ST,8,4,4,5
L40 1SU,L40,1SU,3,1,2,2
L40 1SW,L40,1SW,25,12,13,11
L40 1SX,L40,1SX,1,0,1,1
L40 1SY,L40,1SY,54,28,26,19
L40 1SZ,L40,1SZ,114,59,55,45
L40 1TA,L40,1TA,45,23,22,15
L40 1TB,L40,1TB,34,7,27,2
L40 1TD,L40,1TD,4,2,2,1
L40 1TE,L40,1TE,140,77,63,50
L40 1TF,L40,1TF,58,27,31,22
L40 1TG,L40,1TG,27,16,11,10
L40 1TH,L40,1TH,16,8,8,6
L40 1TJ,L40,1TJ,41,18,23,15
L40 1TL,L40,1TL,15,12,3,4
L40 1TN,L40,1TN,94,49,45,39
L40 1TR,L40,1TR,12,6,6,8
L40 1TS,L40,1TS,37,14,23,11
L40 1TT,L40,1TT,30,13,17,13
L40 1TU,L40,1TU,32,17,15,16
L40 1TW,L40,1TW,20,11,9,8
L40 1TX,L40,1TX,45,27,18,16
L40 1TY,L40,1TY,86,45,41,31
L40 1TZ,L40,1TZ,24,13,11,8
L40 1UA,L40,1UA,46,20,26,18
L40 1UB,L40,1UB,17,8,9,8
L40 1UD,L40,1UD,8,3,5,3
L40 1UE,L40,1UE,21,10,11,12
L40 1UF,L40,1UF,18,11,7,6
L40 1UG,L40,1UG,39,23,16,16
L40 1UH,L40,1UH,68,37,31,28
L40 1UJ,L40,1UJ,25,13,12,12
L40 1UL,L40,1UL,44,23,21,18
L40 1UN,L40,1UN,55,22,33,33
L40 1UP,L40,1UP,19,9,10,6
L40 1UQ,L40,1UQ,5,3,2,2
L40 1UR,L40,1UR,22,10,12,12
L40 1US,L40,1US,68,37,31,22
L40 1UT,L40,1UT,9,4,5,5
L40 1UW,L40,1UW,56,28,28,23
L40 1UX,L40,1UX,42,23,19,14
L40 1UY,L40,1UY,3,1,2,1
L40 1XB,L40,1XB,45,21,24,15
L40 1XD,L40,1XD,21,10,11,7
L40 1XE,L40,1XE,65,30,35,36
L40 2PA,L40,2PA,16,7,9,6
L40 2QA,L40,2QA,16,7,9,4
L40 2QB,L40,2QB,39,23,16,16
L40 2QD,L40,2QD,20,9,11,6
L40 2QE,L40,2QE,36,23,13,11
L40 2QF,L40,2QF,25,12,13,10
L40 2QG,L40,2QG,18,8,10,8
L40 2QH,L40,2QH,8,3,5,4
L40 2QJ,L40,2QJ,82,38,44,33
L40 2QL,L40,2QL,42,18,24,21
L40 2QN,L40,2QN,48,23,25,24
L40 2QP,L40,2QP,72,36,36,33
L40 2QQ,L40,2QQ,17,10,7,11
L40 2QR,L40,2QR,18,8,10,9
L40 2QS,L40,2QS,94,42,52,48
L40 2QT,L40,2QT,27,12,15,14
L40 2QU,L40,2QU,50,22,28,19
L40 2QW,L40,2QW,34,15,19,14
L40 2QX,L40,2QX,16,8,8,7
L40 2QY,L40,2QY,43,20,23,19
L40 2QZ,L40,2QZ,24,15,9,9
L40 2RA,L40,2RA,21,12,9,9
L40 2RB,L40,2RB,7,3,4,1
L40 2RD,L40,2RD,16,10,6,5
L40 2RE,L40,2RE,51,27,24,21
L40 2RF,L40,2RF,35,19,16,15
L40 2RG,L40,2RG,31,17,14,14
L40 2RH,L40,2RH,41,22,19,18
L40 2RJ,L40,2RJ,22,10,12,9
L40 2RL,L40,2RL,18,9,9,7
L40 2RN,L40,2RN,82,42,40,32
L40 2RQ,L40,2RQ,25,13,12,8
L40 2RU,L40,2RU,121,61,60,50
L40 2SB,L40,2SB,3,2,1,1
L40 3AB,L40,3AB,18,11,7,6
L40 3SA,L40,3SA,68,31,37,26
L40 3SB,L40,3SB,10,5,5,5
L40 3SD,L40,3SD,16,7,9,5
L40 3SE,L40,3SE,75,37,38,34
L40 3SF,L40,3SF,44,22,22,18
L40 3SG,L40,3SG,26,12,14,12
L40 3SH,L40,3SH,17,7,10,8
L40 3SJ,L40,3SJ,13,6,7,3
L40 3SL,L40,3SL,27,14,13,13
L40 3SN,L40,3SN,16,8,8,5
L40 3SP,L40,3SP,8,4,4,3
L40 3SQ,L40,3SQ,32,14,18,13
L40 3SR,L40,3SR,15,7,8,6
L40 3SS,L40,3SS,21,12,9,8
L40 3ST,L40,3ST,15,9,6,4
L40 3SU,L40,3SU,8,4,4,3
L40 3SW,L40,3SW,5,3,2,2
L40 3SX,L40,3SX,29,15,14,12
L40 3SY,L40,3SY,10,3,7,5
L40 3SZ,L40,3SZ,8,3,5,4
L40 3TA,L40,3TA,17,9,8,7
L40 3TB,L40,3TB,6,3,3,2
L40 3TD,L40,3TD,30,17,13,15
L40 3TE,L40,3TE,78,40,38,29
L40 3TF,L40,3TF,92,45,47,35
L40 3TG,L40,3TG,12,6,6,6
L40 3TH,L40,3TH,13,7,6,5
L40 3TQ,L40,3TQ,5,3,2,3
L40 3TR,L40,3TR,7,3,4,4
L40 3TW,L40,3TW,24,11,13,11
L40 4AE,L40,4AE,91,46,45,33
L40 4AF,L40,4AF,23,10,13,8
L40 4AG,L40,4AG,25,14,11,14
L40 4AH,L40,4AH,19,10,9,8
L40 4AJ,L40,4AJ,12,5,7,5
L40 4AL,L40,4AL,90,48,42,33
L40 4AQ,L40,4AQ,61,31,30,20
L40 4AR,L40,4AR,58,30,28,22
L40 4AS,L40,4AS,27,13,14,14
L40 4AT,L40,4AT,11,6,5,5
L40 4AU,L40,4AU,64,33,31,22
L40 4AW,L40,4AW,18,7,11,6
L40 4AX,L40,4AX,37,15,22,18
L40 4AY,L40,4AY,14,8,6,7
L40 4AZ,L40,4AZ,34,15,19,16
L40 4BA,L40,4BA,25,13,12,11
L40 4BB,L40,4BB,13,4,9,4
L40 4BD,L40,4BD,13,5,8,7
L40 4BE,L40,4BE,49,18,31,24
L40 4BG,L40,4BG,29,15,14,12
L40 4BH,L40,4BH,15,8,7,6
L40 4BJ,L40,4BJ,22,11,11,7
L40 4BL,L40,4BL,37,16,21,17
L40 4BN,L40,4BN,10,4,6,4
L40 4BP,L40,4BP,14,6,8,5
L40 4BQ,L40,4BQ,46,23,23,24
L40 4BR,L40,4BR,14,9,5,5
L40 4BS,L40,4BS,34,15,19,19
L40 4BT,L40,4BT,58,27,31,19
L40 4BU,L40,4BU,39,22,17,14
L40 4BW,L40,4BW,7,5,2,2
L40 4BX,L40,4BX,54,25,29,23
L40 4BY,L40,4BY,3,2,1,2
L40 4BZ,L40,4BZ,39,21,18,15
L40 4LA,L40,4LA,110,49,61,63
L40 4LB,L40,4LB,77,37,40,29
L40 4LD,L40,4LD,63,35,28,31
L40 4LE,L40,4LE,78,39,39,29
L40 4LF,L40,4LF,52,24,28,21
L40 4LG,L40,4LG,36,19,17,16
L40 4LP,L40,4LP,48,24,24,13
L40 4LQ,L40,4LQ,55,31,24,20
L40 5BD,L40,5BD,117,61,56,42
L40 5BE,L40,5BE,137,66,71,66
L40 5BF,L40,5BF,62,29,33,18
L40 5BG,L40,5BG,46,24,22,15
L40 5BJ,L40,5BJ,23,11,12,7
L40 5BL,L40,5BL,73,33,40,30
L40 5BN,L40,5BN,13,7,6,3
L40 5BP,L40,5BP,57,30,27,25
L40 5BQ,L40,5BQ,46,24,22,12
L40 5BR,L40,5BR,19,13,6,6
L40 5BS,L40,5BS,31,17,14,11
L40 5RS,L40,5RS,13,7,6,6
L40 5SA,L40,5SA,20,13,7,8
L40 5SB,L40,5SB,16,8,8,8
L40 5SD,L40,5SD,28,15,13,11
L40 5SE,L40,5SE,45,20,25,19
L40 5SF,L40,5SF,58,26,32,33
L40 5SG,L40,5SG,8,3,5,3
L40 5SH,L40,5SH,30,18,12,14
L40 5SJ,L40,5SJ,88,39,49,39
L40 5SL,L40,5SL,39,19,20,17
L40 5SN,L40,5SN,60,32,28,22
L40 5SP,L40,5SP,30,12,18,17
L40 5SR,L40,5SR,33,13,20,22
L40 5SS,L40,5SS,56,22,34,20
L40 5SU,L40,5SU,104,49,55,50
L40 5SW,L40,5SW,32,16,16,20
L40 5SX,L40,5SX,132,67,65,46
L40 5SY,L40,5SY,78,37,41,42
L40 5SZ,L40,5SZ,112,50,62,49
L40 5TA,L40,5TA,13,6,7,6
L40 5TB,L40,5TB,102,53,49,43
L40 5TD,L40,5TD,33,16,17,13
L40 5TE,L40,5TE,20,7,13,13
L40 5TF,L40,5TF,43,19,24,24
L40 5TG,L40,5TG,53,24,29,23
L40 5TH,L40,5TH,16,9,7,6
L40 5TJ,L40,5TJ,155,76,79,65
L40 5TN,L40,5TN,46,17,29,18
L40 5TP,L40,5TP,45,14,31,7
L40 5TR,L40,5TR,63,31,32,23
L40 5TS,L40,5TS,7,3,4,3
L40 5TT,L40,5TT,8,3,5,3
L40 5TU,L40,5TU,16,8,8,8
L40 5TW,L40,5TW,88,41,47,48
L40 5TX,L40,5TX,12,8,4,4
L40 5TY,L40,5TY,26,13,13,9
L40 5TZ,L40,5TZ,4,1,3,1
L40 5UA,L40,5UA,34,15,19,15
L40 5UD,L40,5UD,15,8,7,7
L40 5UE,L40,5UE,5,3,2,2
L40 5UG,L40,5UG,18,9,9,10
L40 5UH,L40,5UH,4,2,2,2
L40 5UJ,L40,5UJ,40,22,18,18
L40 5UL,L40,5UL,31,16,15,13
L40 5UN,L40,5UN,21,13,8,10
L40 5UP,L40,5UP,19,10,9,8
L40 5UQ,L40,5UQ,20,11,9,15
L40 5UR,L40,5UR,7,4,3,3
L40 5UT,L40,5UT,20,13,7,10
L40 5UU,L40,5UU,1,1,0,1
L40 5UW,L40,5UW,20,12,8,7
L40 5UY,L40,5UY,61,35,26,26
L40 5UZ,L40,5UZ,38,13,25,27
L40 5XD,L40,5XD,25,10,15,12
L40 5XE,L40,5XE,26,15,11,9
L40 5XF,L40,5XF,33,19,14,12
L40 5XH,L40,5XH,52,23,29,36
L40 5XS,L40,5XS,99,45,54,40
L40 5XT,L40,5XT,25,15,10,13
L40 5XU,L40,5XU,29,14,15,13
L40 5XW,L40,5XW,17,8,9,6
L40 5XX,L40,5XX,15,7,8,6
L40 5XY,L40,5XY,46,26,20,16
L40 5YF,L40,5YF,14,8,6,5
L40 6GA,L40,6GA,8,4,4,5
L40 6HA,L40,6HA,30,17,13,13
L40 6HB,L40,6HB,13,6,7,5
L40 6HD,L40,6HD,21,11,10,7
L40 6HE,L40,6HE,11,3,8,4
L40 6HF,L40,6HF,9,5,4,4
L40 6HG,L40,6HG,32,15,17,12
L40 6HH,L40,6HH,29,13,16,11
L40 6HJ,L40,6HJ,20,9,11,10
L40 6HL,L40,6HL,32,15,17,11
L40 6HN,L40,6HN,41,21,20,17
L40 6HP,L40,6HP,19,9,10,9
L40 6HQ,L40,6HQ,43,20,23,19
L40 6HR,L40,6HR,17,9,8,9
L40 6HS,L40,6HS,64,33,31,29
L40 6HT,L40,6HT,43,16,27,26
L40 6HU,L40,6HU,38,23,15,16
L40 6HW,L40,6HW,15,8,7,5
L40 6HX,L40,6HX,11,6,5,4
L40 6HY,L40,6HY,88,42,46,34
L40 6HZ,L40,6HZ,94,43,51,43
L40 6JA,L40,6JA,27,14,13,11
L40 6JB,L40,6JB,11,5,6,3
L40 6JD,L40,6JD,82,42,40,37
L40 6JE,L40,6JE,81,44,37,31
L40 6JF,L40,6JF,4,2,2,2
L40 6JG,L40,6JG,30,19,11,12
L40 6JH,L40,6JH,75,33,42,31
L40 6JJ,L40,6JJ,4,2,2,2
L40 6JL,L40,6JL,26,12,14,12
L40 6JN,L40,6JN,34,17,17,16
L40 6JP,L40,6JP,21,10,11,10
L40 6JQ,L40,6JQ,31,15,16,13
L40 6JR,L40,6JR,30,16,14,14
L40 6JS,L40,6JS,22,9,13,14
L40 6JU,L40,6JU,33,12,21,12
L40 6JW,L40,6JW,14,5,9,5
L40 6JX,L40,6JX,7,1,6,2
L40 6JZ,L40,6JZ,13,5,8,4
L40 6LA,L40,6LA,4,2,2,2
L40 6LD,L40,6LD,16,10,6,6
L40 6LF,L40,6LF,3,2,1,2
L40 6LG,L40,6LG,2,1,1,1
L40 6LH,L40,6LH,8,3,5,4
L40 6LP,L40,6LP,7,3,4,4
L40 7GA,L40,7GA,12,9,3,7
L40 7RA,L40,7RA,104,51,53,45
L40 7RB,L40,7RB,122,63,59,46
L40 7RD,L40,7RD,121,58,63,47
L40 7RE,L40,7RE,147,76,71,55
L40 7RF,L40,7RF,105,55,50,38
L40 7RG,L40,7RG,123,65,58,48
L40 7RH,L40,7RH,29,13,16,13
L40 7RJ,L40,7RJ,76,37,39,28
L40 7RL,L40,7RL,86,40,46,32
L40 7RN,L40,7RN,124,62,62,48
L40 7RP,L40,7RP,120,60,60,46
L40 7RQ,L40,7RQ,109,46,63,33
L40 7RR,L40,7RR,23,13,10,8
L40 7RS,L40,7RS,16,9,7,7
L40 7RT,L40,7RT,66,35,31,25
L40 7RU,L40,7RU,98,45,53,38
L40 7RW,L40,7RW,62,26,36,27
L40 7RX,L40,7RX,19,7,12,9
L40 7RY,L40,7RY,51,25,26,23
L40 7SA,L40,7SA,82,40,42,24
L40 7SB,L40,7SB,22,11,11,9
L40 7SD,L40,7SD,112,52,60,48
L40 7SE,L40,7SE,73,38,35,32
L40 7SF,L40,7SF,63,33,30,31
L40 7SG,L40,7SG,77,35,42,31
L40 7SH,L40,7SH,22,11,11,8
L40 7SJ,L40,7SJ,74,41,33,31
L40 7SL,L40,7SL,36,20,16,12
L40 7SN,L40,7SN,45,21,24,7
L40 7SP,L40,7SP,19,11,8,6
L40 7SQ,L40,7SQ,71,34,37,35
L40 7SS,L40,7SS,2,2,0,1
L40 7ST,L40,7ST,68,32,36,34
L40 7SU,L40,7SU,106,58,48,42
L40 7SW,L40,7SW,21,9,12,7
L40 7SY,L40,7SY,41,21,20,17
L40 7TA,L40,7TA,97,46,51,35
L40 7TB,L40,7TB,95,47,48,42
L40 7TD,L40,7TD,118,42,76,23
L40 7TE,L40,7TE,24,11,13,11
L40 7TF,L40,7TF,3,2,1,2
L40 7TG,L40,7TG,83,42,41,40
L40 7TH,L40,7TH,84,48,36,31
L40 7TJ,L40,7TJ,65,32,33,23
L40 7TL,L40,7TL,40,14,26,17
L40 7TN,L40,7TN,38,18,20,15
L40 7TQ,L40,7TQ,54,25,29,25
L40 7TR,L40,7TR,53,30,23,22
L40 7TS,L40,7TS,15,7,8,6
L40 7TT,L40,7TT,136,65,71,51
L40 7TU,L40,7TU,168,83,85,54
L40 7TW,L40,7TW,34,15,19,12
L40 7TX,L40,7TX,33,14,19,12
L40 7UA,L40,7UA,25,12,13,21
L40 7UD,L40,7UD,4,1,3,3
L40 7UG,L40,7UG,57,28,29,19
L40 7UH,L40,7UH,13,7,6,5
L40 7UJ,L40,7UJ,89,39,50,27
L40 7UL,L40,7UL,23,12,11,7
L40 7UN,L40,7UN,23,12,11,7
L40 7UP,L40,7UP,18,11,7,6
L40 7UR,L40,7UR,83,43,40,31
L40 7UU,L40,7UU,114,59,55,32
L40 7UW,L40,7UW,23,9,14,10
L40 7UX,L40,7UX,77,44,33,25
L40 7UY,L40,7UY,45,18,27,16
L40 7UZ,L40,7UZ,16,6,10,5
L40 7XA,L40,7XA,8,2,6,6
L40 7XB,L40,7XB,39,18,21,13
L40 7XG,L40,7XG,24,13,11,8
L40 8HA,L40,8HA,7,4,3,3
L40 8HB,L40,8HB,72,36,36,47
L40 8HD,L40,8HD,22,12,10,9
L40 8HE,L40,8HE,12,6,6,7
L40 8HF,L40,8HF,16,9,7,5
L40 8HG,L40,8HG,19,8,11,8
L40 8HH,L40,8HH,72,34,38,23
L40 8HJ,L40,8HJ,196,110,86,106
L40 8HL,L40,8HL,25,11,14,9
L40 8HN,L40,8HN,5,0,5,1
L40 8HP,L40,8HP,8,4,4,3
L40 8HQ,L40,8HQ,35,16,19,11
L40 8HR,L40,8HR,38,20,18,17
L40 8HT,L40,8HT,2,1,1,1
L40 8HU,L40,8HU,5,3,2,1
L40 8HW,L40,8HW,61,31,30,24
L40 8HX,L40,8HX,12,7,5,5
L40 8HY,L40,8HY,18,9,9,8
L40 8HZ,L40,8HZ,44,26,18,13
L40 8JA,L40,8JA,31,21,10,10
L40 8JB,L40,8JB,2,2,0,2
L40 8JD,L40,8JD,62,35,27,22
L40 8JE,L40,8JE,25,13,12,12
L40 8JF,L40,8JF,20,10,10,10
L40 8JG,L40,8JG,49,23,26,16
L40 8JH,L40,8JH,15,7,8,5
L40 8JJ,L40,8JJ,15,7,8,6
L40 8JL,L40,8JL,93,33,60,16
L40 8JN,L40,8JN,3,1,2,2
L40 8JQ,L40,8JQ,15,10,5,5
L40 8JR,L40,8JR,5,4,1,2
L40 8LD,L40,8LD,5,2,3,2
L40 8LG,L40,8LG,20,10,10,9
L40 9PZ,L40,9PZ,22,9,13,15
L40 9QA,L40,9QA,64,34,30,29
L40 9QB,L40,9QB,71,36,35,25
L40 9QD,L40,9QD,18,9,9,6
L40 9QE,L40,9QE,4,2,2,2
L40 9QF,L40,9QF,9,5,4,4
L40 9QG,L40,9QG,97,46,51,43
L40 9QH,L40,9QH,31,15,16,13
L40 9QJ,L40,9QJ,18,7,11,9
L40 9QL,L40,9QL,25,11,14,12
L40 9QN,L40,9QN,64,30,34,23
L40 9QR,L40,9QR,35,16,19,11
L40 9QS,L40,9QS,30,16,14,14
L40 9QT,L40,9QT,36,18,18,16
L40 9QX,L40,9QX,16,6,10,8
L40 9QY,L40,9QY,21,12,9,9
L40 9QZ,L40,9QZ,17,8,9,6
L40 9RA,L40,9RA,38,20,18,15
L40 9RB,L40,9RB,77,40,37,31
L40 9RD,L40,9RD,43,24,19,12
L40 9RE,L40,9RE,55,27,28,24
L40 9RF,L40,9RF,89,45,44,40
L40 9RG,L40,9RG,17,7,10,8
L40 9RH,L40,9RH,18,9,9,7
L40 9RJ,L40,9RJ,64,34,30,25
L40 9RL,L40,9RL,33,20,13,10
L40 9RN,L40,9RN,28,15,13,16
L40 9RP,L40,9RP,16,8,8,5
L40 9RR,L40,9RR,14,8,6,7
L40 9RS,L40,9RS,58,32,26,25
L40 9RT,L40,9RT,29,14,15,8
L40 9RU,L40,9RU,2,1,1,1
L40 9RX,L40,9RX,23,9,14,12
L40 9RZ,L40,9RZ,22,10,12,10
L40 9SA,L40,9SA,13,6,7,7
L40 9SB,L40,9SB,21,9,12,7
L40 9SD,L40,9SD,33,14,19,23
L40 9SE,L40,9SE,16,9,7,7
L40 9SW,L40,9SW,2,1,1,1
L5  0BA,L5,0BA,50,26,24,18
L5  0BB,L5,0BB,143,62,81,59
L5  0BD,L5,0BD,105,49,56,39
L5  0BL,L5,0BL,17,5,12,9
L5  0BN,L5,0BN,15,6,9,9
L5  0PJ,L5,0PJ,64,32,32,27
L5  0PR,L5,0PR,74,38,36,37
L5  0PS,L5,0PS,57,28,29,25
L5  0PZ,L5,0PZ,60,26,34,19
L5  0QD,L5,0QD,74,35,39,31
L5  0QW,L5,0QW,64,32,32,31
L5  0QX,L5,0QX,18,8,10,9
L5  0RA,L5,0RA,18,14,4,18
L5  0RD,L5,0RD,91,48,43,46
L5  0RE,L5,0RE,34,16,18,13
L5  0RF,L5,0RF,100,49,51,61
L5  0RH,L5,0RH,18,10,8,12
L5  0RN,L5,0RN,50,25,25,14
L5  0RQ,L5,0RQ,7,3,4,2
L5  0RR,L5,0RR,32,18,14,16
L5  0RS,L5,0RS,21,11,10,9
L5  0RW,L5,0RW,15,8,7,7
L5  0RX,L5,0RX,33,18,15,23
L5  0RZ,L5,0RZ,69,27,42,31
L5  0SL,L5,0SL,23,10,13,6
L5  0SU,L5,0SU,101,48,53,45
L5  0SX,L5,0SX,68,29,39,32
L5  0SY,L5,0SY,69,35,34,34
L5  0SZ,L5,0SZ,41,19,22,17
L5  0TB,L5,0TB,62,30,32,40
L5  0TD,L5,0TD,53,26,27,34
L5  0TE,L5,0TE,26,14,12,18
L5  0TF,L5,0TF,27,19,8,23
L5  0TU,L5,0TU,109,45,64,39
L5  1TA,L5,1TA,31,13,18,14
L5  1TG,L5,1TG,32,16,16,13
L5  1TH,L5,1TH,34,18,16,22
L5  1TP,L5,1TP,33,12,21,14
L5  1TW,L5,1TW,150,71,79,48
L5  1TX,L5,1TX,78,35,43,40
L5  1UA,L5,1UA,2,1,1,1
L5  1UE,L5,1UE,13,4,9,8
L5  1UF,L5,1UF,6,1,5,3
L5  1UH,L5,1UH,7,4,3,3
L5  1UR,L5,1UR,6,3,3,5
L5  1UW,L5,1UW,8,4,4,2
L5  1UX,L5,1UX,1,1,0,1
L5  1UY,L5,1UY,2,2,0,2
L5  1XG,L5,1XG,33,13,20,29
L5  1XH,L5,1XH,51,17,34,41
L5  1XJ,L5,1XJ,33,16,17,12
L5  1XL,L5,1XL,2,1,1,1
L5  1XQ,L5,1XQ,23,7,16,8
L5  2AR,L5,2AR,55,23,32,33
L5  2AT,L5,2AT,30,11,19,19
L5  2BD,L5,2BD,10,5,5,7
L5  2BG,L5,2BG,8,6,2,7
L5  2BH,L5,2BH,9,4,5,6
L5  2BJ,L5,2BJ,12,9,3,8
L5  2PA,L5,2PA,10,4,6,4
L5  2PG,L5,2PG,33,16,17,12
L5  2PJ,L5,2PJ,13,7,6,6
L5  2PL,L5,2PL,18,12,6,9
L5  2PT,L5,2PT,22,13,9,7
L5  2PX,L5,2PX,3,1,2,2
L5  2PY,L5,2PY,9,2,7,4
L5  2QE,L5,2QE,1,0,1,1
L5  2QH,L5,2QH,48,20,28,24
L5  2QN,L5,2QN,27,21,6,19
L5  2QQ,L5,2QQ,13,6,7,5
L5  2QS,L5,2QS,117,47,70,35
L5  2QT,L5,2QT,24,13,11,14
L5  2QX,L5,2QX,48,22,26,23
L5  2QY,L5,2QY,86,40,46,55
L5  2RA,L5,2RA,72,31,41,28
L5  2RE,L5,2RE,20,12,8,9
L5  2RF,L5,2RF,34,13,21,13
L5  2RR,L5,2RR,17,5,12,8
L5  2RU,L5,2RU,20,11,9,9
L5  2RY,L5,2RY,28,15,13,12
L5  2RZ,L5,2RZ,11,5,6,7
L5  2SA,L5,2SA,19,5,14,12
L5  2SE,L5,2SE,11,5,6,6
L5  2SF,L5,2SF,25,12,13,16
L5  2SH,L5,2SH,25,12,13,12
L5  2SJ,L5,2SJ,24,11,13,9
L5  2SL,L5,2SL,51,23,28,20
L5  2SP,L5,2SP,19,8,11,9
L5  2SR,L5,2SR,49,26,23,16
L5  2SS,L5,2SS,21,11,10,14
L5  2ST,L5,2ST,54,23,31,39
L5  2SU,L5,2SU,23,8,15,9
L5  2SW,L5,2SW,43,33,10,39
L5  2SX,L5,2SX,6,3,3,2
L5  2SZ,L5,2SZ,13,7,6,7
L5  3BA,L5,3BA,93,54,39,66
L5  3BB,L5,3BB,113,66,47,75
L5  3LA,L5,3LA,24,7,17,9
L5  3LB,L5,3LB,11,6,5,4
L5  3LF,L5,3LF,8,2,6,2
L5  3LU,L5,3LU,1,1,0,1
L5  3LW,L5,3LW,28,12,16,10
L5  3ND,L5,3ND,27,19,8,25
L5  3NG,L5,3NG,20,11,9,8
L5  3NW,L5,3NW,15,8,7,6
L5  3NZ,L5,3NZ,22,10,12,6
L5  3PD,L5,3PD,66,38,28,31
L5  3PE,L5,3PE,46,25,21,18
L5  3PF,L5,3PF,16,8,8,9
L5  3PH,L5,3PH,12,7,5,5
L5  3PJ,L5,3PJ,16,8,8,9
L5  3PT,L5,3PT,58,30,28,36
L5  3PU,L5,3PU,48,20,28,16
L5  3QE,L5,3QE,42,19,23,12
L5  3QF,L5,3QF,8,6,2,7
L5  3QG,L5,3QG,6,3,3,4
L5  3QN,L5,3QN,60,32,28,47
L5  3QQ,L5,3QQ,39,29,10,34
L5  3QW,L5,3QW,63,39,24,54
L5  3RJ,L5,3RJ,11,8,3,8
L5  3RL,L5,3RL,31,24,7,29
L5  3RN,L5,3RN,39,27,12,32
L5  3RX,L5,3RX,45,22,23,12
L5  3SA,L5,3SA,35,18,17,14
L5  3SB,L5,3SB,21,5,16,11
L5  3SD,L5,3SD,38,20,18,9
L5  3SG,L5,3SG,38,23,15,12
L5  3SH,L5,3SH,117,55,62,55
L5  3SJ,L5,3SJ,26,15,11,22
L5  3SL,L5,3SL,35,13,22,16
L5  3SN,L5,3SN,24,11,13,6
L5  3SR,L5,3SR,36,18,18,30
L5  3SS,L5,3SS,17,9,8,8
L5  3ST,L5,3ST,56,28,28,22
L5  3SU,L5,3SU,36,16,20,15
L5  3SW,L5,3SW,16,6,10,6
L5  3SX,L5,3SX,18,7,11,7
L5  3SY,L5,3SY,39,26,13,25
L5  3SZ,L5,3SZ,20,10,10,16
L5  4LH,L5,4LH,3,0,3,1
L5  4LJ,L5,4LJ,6,3,3,2
L5  4LS,L5,4LS,25,15,10,15
L5  4NH,L5,4NH,42,23,19,20
L5  4NJ,L5,4NJ,5,2,3,1
L5  4NQ,L5,4NQ,13,6,7,8
L5  4PJ,L5,4PJ,54,21,33,22
L5  4PN,L5,4PN,54,30,24,25
L5  4PY,L5,4PY,1,1,0,1
L5  4QA,L5,4QA,2,1,1,1
L5  4QT,L5,4QT,24,19,5,19
L5  4QZ,L5,4QZ,10,7,3,3
L5  4RP,L5,4RP,2,2,0,1
L5  4RT,L5,4RT,64,26,38,30
L5  4SU,L5,4SU,54,27,27,20
L5  4SX,L5,4SX,79,37,42,32
L5  4SY,L5,4SY,97,48,49,40
L5  4SZ,L5,4SZ,49,26,23,20
L5  4TA,L5,4TA,51,22,29,22
L5  4TB,L5,4TB,40,17,23,20
L5  4TD,L5,4TD,31,17,14,17
L5  4TE,L5,4TE,139,65,74,58
L5  4TF,L5,4TF,36,18,18,18
L5  4TG,L5,4TG,53,25,28,26
L5  4TH,L5,4TH,22,13,9,11
L5  4TJ,L5,4TJ,133,65,68,52
L5  4TL,L5,4TL,75,34,41,27
L5  4TN,L5,4TN,38,18,20,21
L5  4TP,L5,4TP,54,27,27,22
L5  4TQ,L5,4TQ,39,24,15,28
L5  4TR,L5,4TR,42,24,18,35
L5  4TW,L5,4TW,17,9,8,9
L5  5AE,L5,5AE,11,10,1,0
L5  5AQ,L5,5AQ,7,4,3,2
L5  5AS,L5,5AS,4,3,1,2
L5  5BD,L5,5BD,1,1,0,1
L5  5BE,L5,5BE,74,40,34,42
L5  5BH,L5,5BH,43,27,16,18
L5  5BJ,L5,5BJ,1,0,1,1
L5  5BL,L5,5BL,5,2,3,4
L5  5BP,L5,5BP,57,26,31,33
L5  5BQ,L5,5BQ,76,38,38,39
L5  5DX,L5,5DX,35,26,9,33
L5  5DY,L5,5DY,10,5,5,7
L5  5DZ,L5,5DZ,51,23,28,30
L5  5EH,L5,5EH,46,25,21,27
L5  5EJ,L5,5EJ,44,20,24,25
L5  5EL,L5,5EL,63,45,18,42
L5  5EP,L5,5EP,7,3,4,3
L5  5ER,L5,5ER,3,1,2,1
L5  5ES,L5,5ES,21,15,6,9
L5  5EY,L5,5EY,65,32,33,32
L5  5EZ,L5,5EZ,30,17,13,10
L5  5HA,L5,5HA,35,21,14,24
L5  5HN,L5,5HN,6,4,2,5
L5  5HX,L5,5HX,60,23,37,22
L5  5HY,L5,5HY,6,1,5,4
L5  5JA,L5,5JA,7,3,4,5
L5  6PA,L5,6PA,91,42,49,44
L5  6PB,L5,6PB,33,14,19,21
L5  6PD,L5,6PD,7,2,5,4
L5  6PE,L5,6PE,58,31,27,33
L5  6PF,L5,6PF,56,27,29,38
L5  6PH,L5,6PH,8,6,2,7
L5  6PJ,L5,6PJ,12,5,7,8
L5  6PL,L5,6PL,106,51,55,50
L5  6PN,L5,6PN,5,2,3,4
L5  6PP,L5,6PP,16,10,6,9
L5  6PR,L5,6PR,45,22,23,20
L5  6PT,L5,6PT,9,7,2,6
L5  6PU,L5,6PU,6,4,2,2
L5  6PW,L5,6PW,18,7,11,8
L5  6QB,L5,6QB,7,4,3,3
L5  6QL,L5,6QL,4,2,2,2
L5  6QP,L5,6QP,52,20,32,24
L5  6QR,L5,6QR,62,27,35,29
L5  6QS,L5,6QS,56,25,31,28
L5  6QT,L5,6QT,76,31,45,29
L5  6QU,L5,6QU,40,16,24,20
L5  6QX,L5,6QX,74,45,29,39
L5  6QY,L5,6QY,74,31,43,32
L5  6QZ,L5,6QZ,77,38,39,37
L5  6RA,L5,6RA,9,5,4,4
L5  6RB,L5,6RB,9,2,7,4
L5  6RH,L5,6RH,86,40,46,36
L5  6RJ,L5,6RJ,47,23,24,23
L5  6RN,L5,6RN,2,1,1,2
L5  6RP,L5,6RP,144,84,60,86
L5  6RQ,L5,6RQ,4,2,2,2
L5  6RR,L5,6RR,66,44,22,47
L5  6RS,L5,6RS,45,18,27,16
L5  6RU,L5,6RU,7,4,3,4
L5  6RW,L5,6RW,201,97,104,90
L5  6RX,L5,6RX,16,7,9,8
L5  6RY,L5,6RY,101,47,54,37
L5  6RZ,L5,6RZ,65,31,34,29
L5  6SA,L5,6SA,86,41,45,37
L5  6SB,L5,6SB,63,29,34,26
L5  6SE,L5,6SE,69,31,38,28
L5  6SF,L5,6SF,34,14,20,20
L5  6SG,L5,6SG,75,31,44,30
L5  6SL,L5,6SL,37,22,15,35
L5  6SQ,L5,6SQ,48,21,27,21
L5  6SU,L5,6SU,82,50,32,38
L5  6SX,L5,6SX,112,56,56,65
L5  7QB,L5,7QB,5,3,2,4
L5  7QD,L5,7QD,29,23,6,13
L5  7QF,L5,7QF,37,17,20,15
L5  7QP,L5,7QP,29,16,13,12
L5  7QQ,L5,7QQ,2,1,1,1
L5  7QY,L5,7QY,66,31,35,40
L5  7RA,L5,7RA,59,34,25,27
L5  7RB,L5,7RB,39,20,19,17
L5  7RL,L5,7RL,42,22,20,24
L5  7RN,L5,7RN,46,27,19,26
L5  7RP,L5,7RP,58,31,27,30
L5  7RR,L5,7RR,85,41,44,41
L5  7RS,L5,7RS,77,40,37,39
L5  7RT,L5,7RT,62,30,32,31
L5  7RU,L5,7RU,33,16,17,17
L5  7RW,L5,7RW,60,27,33,26
L5  7RZ,L5,7RZ,26,11,15,13
L5  7SB,L5,7SB,51,21,30,20
L5  7SG,L5,7SG,15,8,7,6
L5  7SH,L5,7SH,45,21,24,18
L5  7SP,L5,7SP,4,3,1,3
L5  7SQ,L5,7SQ,69,31,38,24
L5  7SS,L5,7SS,19,7,12,10
L5  7SU,L5,7SU,36,11,25,18
L5  7TA,L5,7TA,7,4,3,6
L5  7TB,L5,7TB,30,21,9,18
L5  7TR,L5,7TR,39,20,19,17
L5  7TS,L5,7TS,51,21,30,23
L5  7TT,L5,7TT,35,15,20,17
L5  7TU,L5,7TU,60,26,34,30
L5  7TX,L5,7TX,38,20,18,13
L5  7TY,L5,7TY,52,26,26,21
L5  7TZ,L5,7TZ,27,13,14,14
L5  7UA,L5,7UA,47,22,25,20
L5  7UB,L5,7UB,11,8,3,5
L5  8SA,L5,8SA,44,20,24,36
L5  8SB,L5,8SB,4,1,3,2
L5  8SE,L5,8SE,24,11,13,8
L5  8SF,L5,8SF,72,40,32,42
L5  8SG,L5,8SG,20,8,12,13
L5  8SL,L5,8SL,8,4,4,5
L5  8SU,L5,8SU,34,15,19,15
L5  8SX,L5,8SX,28,12,16,12
L5  8SZ,L5,8SZ,43,16,27,24
L5  8TN,L5,8TN,10,6,4,5
L5  8TS,L5,8TS,8,4,4,7
L5  8TZ,L5,8TZ,7,6,1,6
L5  8US,L5,8US,79,51,28,61
L5  8UT,L5,8UT,38,21,17,19
L5  8UX,L5,8UX,29,14,15,14
L5  8UY,L5,8UY,18,9,9,10
L5  8XE,L5,8XE,12,4,8,6
L5  8XH,L5,8XH,17,9,8,9
L5  8XJ,L5,8XJ,89,42,47,47
L5  8XL,L5,8XL,37,21,16,16
L5  8XN,L5,8XN,2,1,1,1
L5  8XS,L5,8XS,29,13,16,16
L5  8XT,L5,8XT,26,9,17,11
L5  8XU,L5,8XU,19,7,12,10
L5  8XW,L5,8XW,6,4,2,4
L5  8XX,L5,8XX,19,8,11,8
L5  8XY,L5,8XY,33,14,19,15
L5  8XZ,L5,8XZ,25,14,11,13
L5  8YB,L5,8YB,7,5,2,2
L5  8YD,L5,8YD,23,9,14,10
L5  8YE,L5,8YE,30,14,16,12
L5  8YF,L5,8YF,91,50,41,57
L5  8YG,L5,8YG,19,10,9,12
L5  8YL,L5,8YL,23,13,10,13
L5  8YP,L5,8YP,51,20,31,20
L5  8YQ,L5,8YQ,17,9,8,10
L5  8YR,L5,8YR,6,4,2,5
L5  8YS,L5,8YS,30,17,13,16
L5  8YT,L5,8YT,22,10,12,9
L5  8YU,L5,8YU,4,3,1,2
L5  8YW,L5,8YW,64,27,37,24
L5  9RA,L5,9RA,84,42,42,40
L5  9RB,L5,9RB,55,29,26,26
L5  9RE,L5,9RE,17,9,8,8
L5  9RF,L5,9RF,18,9,9,9
L5  9RG,L5,9RG,31,14,17,16
L5  9RJ,L5,9RJ,2,1,1,1
L5  9RP,L5,9RP,93,47,46,41
L5  9RQ,L5,9RQ,46,25,21,24
L5  9RR,L5,9RR,73,39,34,30
L5  9RS,L5,9RS,67,26,41,28
L5  9RT,L5,9RT,17,8,9,7
L5  9RU,L5,9RU,7,5,2,2
L5  9RW,L5,9RW,29,11,18,10
L5  9RX,L5,9RX,43,17,26,18
L5  9RY,L5,9RY,46,23,23,20
L5  9RZ,L5,9RZ,13,6,7,9
L5  9TD,L5,9TD,2,0,2,1
L5  9XB,L5,9XB,125,66,59,79
L5  9XS,L5,9XS,39,28,11,23
L6  0AA,L6,0AA,22,11,11,16
L6  0AB,L6,0AB,42,20,22,18
L6  0AE,L6,0AE,168,70,98,28
L6  0AF,L6,0AF,37,17,20,15
L6  0AG,L6,0AG,9,3,6,4
L6  0AH,L6,0AH,56,29,27,18
L6  0AJ,L6,0AJ,60,22,38,40
L6  0AL,L6,0AL,62,28,34,39
L6  0AN,L6,0AN,48,23,25,30
L6  0AP,L6,0AP,64,31,33,38
L6  0AQ,L6,0AQ,15,8,7,7
L6  0AR,L6,0AR,22,8,14,10
L6  0AS,L6,0AS,36,19,17,17
L6  0AT,L6,0AT,45,18,27,18
L6  0AU,L6,0AU,56,27,29,21
L6  0AW,L6,0AW,37,16,21,21
L6  0AX,L6,0AX,42,29,13,24
L6  0AY,L6,0AY,35,16,19,11
L6  0AZ,L6,0AZ,60,25,35,23
L6  0BA,L6,0BA,43,27,16,27
L6  0BB,L6,0BB,3,2,1,2
L6  0BH,L6,0BH,80,37,43,33
L6  0BJ,L6,0BJ,102,50,52,38
L6  0BL,L6,0BL,85,35,50,39
L6  0BN,L6,0BN,116,41,75,44
L6  0BP,L6,0BP,77,50,27,38
L6  0BR,L6,0BR,72,34,38,38
L6  0BS,L6,0BS,89,46,43,43
L6  0BT,L6,0BT,92,42,50,39
L6  0BU,L6,0BU,90,42,48,46
L6  0BW,L6,0BW,97,49,48,50
L6  0BX,L6,0BX,72,29,43,31
L6  0BY,L6,0BY,133,58,75,63
L6  0BZ,L6,0BZ,116,61,55,54
L6  0DA,L6,0DA,18,8,10,7
L6  0DE,L6,0DE,11,7,4,5
L6  0DG,L6,0DG,58,25,33,30
L6  0DH,L6,0DH,33,13,20,16
L6  0DJ,L6,0DJ,34,18,16,15
L6  0DL,L6,0DL,25,10,15,9
L6  0DP,L6,0DP,90,45,45,42
L6  0DQ,L6,0DQ,23,10,13,10
L6  0DW,L6,0DW,83,42,41,39
L6  1AE,L6,1AE,2,1,1,1
L6  1AU,L6,1AU,5,3,2,4
L6  1BA,L6,1BA,576,260,316,76
L6  1BS,L6,1BS,3,3,0,3
L6  1DE,L6,1DE,8,4,4,6
L6  1DL,L6,1DL,18,12,6,6
L6  1EA,L6,1EA,13,9,4,10
L6  1EG,L6,1EG,80,47,33,52
L6  1EH,L6,1EH,15,6,9,6
L6  1EJ,L6,1EJ,5,4,1,5
L6  1EN,L6,1EN,35,13,22,18
L6  1EP,L6,1EP,24,14,10,11
L6  1EX,L6,1EX,22,10,12,11
L6  1HA,L6,1HA,128,80,48,90
L6  1HB,L6,1HB,9,4,5,6
L6  1HD,L6,1HD,556,218,338,4
L6  1HE,L6,1HE,20,11,9,14
L6  1HF,L6,1HF,14,7,7,12
L6  1HL,L6,1HL,57,36,21,43
L6  1HU,L6,1HU,2,1,1,1
L6  1JJ,L6,1JJ,17,7,10,7
L6  1JL,L6,1JL,58,29,29,25
L6  1JN,L6,1JN,10,5,5,4
L6  1JS,L6,1JS,14,5,9,5
L6  1JW,L6,1JW,60,32,28,28
L6  1JX,L6,1JX,50,22,28,24
L6  1LX,L6,1LX,36,17,19,13
L6  1NA,L6,1NA,1,0,1,1
L6  1NJ,L6,1NJ,63,28,35,25
L6  1NL,L6,1NL,42,18,24,17
L6  1NN,L6,1NN,41,18,23,18
L6  1NP,L6,1NP,27,13,14,12
L6  1NR,L6,1NR,21,11,10,9
L6  1NS,L6,1NS,11,5,6,6
L6  1NT,L6,1NT,8,6,2,8
L6  1NW,L6,1NW,45,24,21,23
L6  1NX,L6,1NX,57,24,33,27
L6  1NY,L6,1NY,10,5,5,7
L6  1NZ,L6,1NZ,40,22,18,16
L6  1PA,L6,1PA,40,19,21,19
L6  1PB,L6,1PB,15,5,10,8
L6  1PH,L6,1PH,51,21,30,28
L6  1PJ,L6,1PJ,29,14,15,14
L6  1PQ,L6,1PQ,63,45,18,42
L6  1RD,L6,1RD,18,11,7,7
L6  1RE,L6,1RE,6,3,3,4
L6  1RF,L6,1RF,44,18,26,21
L6  2AA,L6,2AA,23,12,11,10
L6  2AB,L6,2AB,8,4,4,2
L6  2AG,L6,2AG,2,1,1,1
L6  2AL,L6,2AL,39,21,18,15
L6  2AR,L6,2AR,23,12,11,8
L6  2AT,L6,2AT,54,32,22,34
L6  2AU,L6,2AU,58,29,29,28
L6  2AW,L6,2AW,9,5,4,3
L6  2BB,L6,2BB,64,26,38,24
L6  2BD,L6,2BD,32,12,20,23
L6  2BG,L6,2BG,48,24,24,22
L6  2BL,L6,2BL,64,30,34,23
L6  2BQ,L6,2BQ,68,31,37,32
L6  2BZ,L6,2BZ,47,20,27,20
L6  2DY,L6,2DY,33,14,19,16
L6  2EH,L6,2EH,33,18,15,21
L6  2EN,L6,2EN,1,1,0,1
L6  2EP,L6,2EP,9,5,4,6
L6  2ER,L6,2ER,10,4,6,6
L6  2EW,L6,2EW,4,1,3,2
L6  2EY,L6,2EY,22,6,16,11
L6  2HW,L6,2HW,29,9,20,11
L6  2JA,L6,2JA,23,11,12,11
L6  2JB,L6,2JB,34,14,20,18
L6  2JD,L6,2JD,16,7,9,6
L6  2JE,L6,2JE,13,6,7,4
L6  2JF,L6,2JF,24,13,11,10
L6  2JG,L6,2JG,69,29,40,38
L6  2JH,L6,2JH,17,9,8,10
L6  2JL,L6,2JL,17,10,7,6
L6  2JN,L6,2JN,33,19,14,18
L6  2LD,L6,2LD,4,2,2,1
L6  2LX,L6,2LX,26,9,17,11
L6  2LY,L6,2LY,61,33,28,23
L6  2LZ,L6,2LZ,53,28,25,21
L6  2NA,L6,2NA,39,13,26,16
L6  2NB,L6,2NB,36,19,17,14
L6  2NF,L6,2NF,27,7,20,14
L6  2NG,L6,2NG,41,15,26,14
L6  2NL,L6,2NL,8,3,5,5
L6  2NX,L6,2NX,70,25,45,32
L6  2PA,L6,2PA,57,23,34,31
L6  2PB,L6,2PB,85,39,46,30
L6  2PD,L6,2PD,78,31,47,36
L6  2PE,L6,2PE,40,18,22,17
L6  2PF,L6,2PF,79,41,38,34
L6  2PG,L6,2PG,66,30,36,26
L6  2PH,L6,2PH,46,18,28,19
L6  2PJ,L6,2PJ,37,20,17,16
L6  2PL,L6,2PL,8,4,4,6
L6  2PN,L6,2PN,17,6,11,8
L6  2PQ,L6,2PQ,38,18,20,15
L6  2PW,L6,2PW,15,10,5,8
L6  2WB,L6,2WB,39,21,18,19
L6  2WD,L6,2WD,36,18,18,16
L6  2WE,L6,2WE,14,7,7,9
L6  2WF,L6,2WF,7,5,2,3
L6  2WG,L6,2WG,46,24,22,24
L6  2WH,L6,2WH,36,12,24,28
L6  2WJ,L6,2WJ,44,20,24,25
L6  2WL,L6,2WL,48,32,16,39
L6  2WN,L6,2WN,44,22,22,23
L6  2WQ,L6,2WQ,50,27,23,29
L6  3AA,L6,3AA,4,2,2,3
L6  3AB,L6,3AB,68,39,29,31
L6  3AD,L6,3AD,74,44,30,35
L6  3AE,L6,3AE,101,69,32,57
L6  3AF,L6,3AF,74,41,33,48
L6  3AG,L6,3AG,65,31,34,29
L6  3AJ,L6,3AJ,102,53,49,69
L6  3AL,L6,3AL,50,30,20,26
L6  3AN,L6,3AN,68,39,29,38
L6  3AP,L6,3AP,56,31,25,36
L6  3AQ,L6,3AQ,90,46,44,35
L6  3AR,L6,3AR,61,32,29,36
L6  3AS,L6,3AS,88,48,40,49
L6  3AT,L6,3AT,62,36,26,35
L6  3AU,L6,3AU,134,93,41,98
L6  3AW,L6,3AW,70,37,33,39
L6  3BA,L6,3BA,77,49,28,50
L6  3BB,L6,3BB,120,81,39,76
L6  3BD,L6,3BD,141,79,62,73
L6  3BE,L6,3BE,114,71,43,72
L6  3BS,L6,3BS,16,9,7,10
L6  3BT,L6,3BT,57,29,28,47
L6  3BU,L6,3BU,22,13,9,19
L6  3BX,L6,3BX,66,33,33,43
L6  3BY,L6,3BY,65,33,32,41
L6  3BZ,L6,3BZ,57,32,25,35
L6  3DA,L6,3DA,22,10,12,12
L6  4AA,L6,4AA,22,15,7,12
L6  4AB,L6,4AB,30,18,12,16
L6  4AD,L6,4AD,1,1,0,1
L6  4AG,L6,4AG,59,35,24,33
L6  4AH,L6,4AH,59,32,27,25
L6  4AJ,L6,4AJ,56,26,30,26
L6  4AL,L6,4AL,73,32,41,35
L6  4AN,L6,4AN,68,26,42,25
L6  4AP,L6,4AP,80,38,42,40
L6  4AQ,L6,4AQ,70,34,36,39
L6  4AR,L6,4AR,13,9,4,7
L6  4AS,L6,4AS,81,36,45,36
L6  4AT,L6,4AT,66,34,32,39
L6  4AU,L6,4AU,52,24,28,38
L6  4AW,L6,4AW,52,19,33,28
L6  4AX,L6,4AX,53,26,27,36
L6  4AY,L6,4AY,58,30,28,32
L6  4AZ,L6,4AZ,61,28,33,33
L6  4BA,L6,4BA,89,59,30,50
L6  4BB,L6,4BB,57,44,13,40
L6  4BD,L6,4BD,55,38,17,39
L6  4BE,L6,4BE,43,28,15,23
L6  4BG,L6,4BG,60,28,32,24
L6  4BH,L6,4BH,67,48,19,36
L6  4BJ,L6,4BJ,91,58,33,33
L6  4BL,L6,4BL,1,1,0,1
L6  4BN,L6,4BN,19,15,4,15
L6  4BQ,L6,4BQ,52,32,20,28
L6  4BS,L6,4BS,109,56,53,48
L6  4BT,L6,4BT,92,45,47,46
L6  4BU,L6,4BU,25,13,12,12
L6  4BW,L6,4BW,27,19,8,15
L6  4BX,L6,4BX,16,13,3,13
L6  4BY,L6,4BY,52,41,11,18
L6  4BZ,L6,4BZ,40,26,14,25
L6  4DA,L6,4DA,56,35,21,18
L6  4DB,L6,4DB,64,29,35,29
L6  4DE,L6,4DE,127,66,61,54
L6  4DF,L6,4DF,102,70,32,40
L6  4DG,L6,4DG,90,45,45,41
L6  4DH,L6,4DH,42,17,25,23
L6  4DJ,L6,4DJ,167,75,92,79
L6  4DL,L6,4DL,34,20,14,7
L6  4DN,L6,4DN,145,71,74,50
L6  4DP,L6,4DP,82,45,37,32
L6  4DQ,L6,4DQ,114,57,57,46
L6  4DR,L6,4DR,36,18,18,19
L6  4DS,L6,4DS,100,48,52,39
L6  4DT,L6,4DT,56,37,19,31
L6  4DU,L6,4DU,56,23,33,30
L6  4DX,L6,4DX,94,52,42,41
L6  4DY,L6,4DY,65,27,38,27
L6  4DZ,L6,4DZ,99,45,54,39
L6  4EA,L6,4EA,19,10,9,13
L6  4EB,L6,4EB,37,22,15,21
L6  4ED,L6,4ED,6,1,5,5
L6  4EE,L6,4EE,20,9,11,7
L6  4EH,L6,4EH,15,9,6,0
L6  4EL,L6,4EL,8,4,4,4
L6  4EN,L6,4EN,120,58,62,42
L6  4EQ,L6,4EQ,46,26,20,40
L6  4ER,L6,4ER,56,28,28,19
L6  4ES,L6,4ES,55,25,30,19
L6  4ET,L6,4ET,187,93,94,75
L6  4EU,L6,4EU,42,18,24,16
L6  4EY,L6,4EY,5,2,3,4
L6  4EZ,L6,4EZ,7,3,4,4
L6  5AA,L6,5AA,99,53,46,48
L6  5AB,L6,5AB,31,19,12,13
L6  5AD,L6,5AD,23,14,9,7
L6  5AE,L6,5AE,61,33,28,35
L6  5AF,L6,5AF,75,32,43,43
L6  5AG,L6,5AG,115,60,55,37
L6  5AH,L6,5AH,69,38,31,34
L6  5AJ,L6,5AJ,33,12,21,13
L6  5AL,L6,5AL,117,65,52,44
L6  5AN,L6,5AN,106,60,46,47
L6  5AQ,L6,5AQ,86,41,45,36
L6  5AW,L6,5AW,110,45,65,47
L6  5AY,L6,5AY,103,54,49,48
L6  5AZ,L6,5AZ,109,56,53,41
L6  5BJ,L6,5BJ,142,78,64,78
L6  5BR,L6,5BR,14,12,2,12
L6  5DB,L6,5DB,38,18,20,13
L6  5DR,L6,5DR,1,1,0,1
L6  5DW,L6,5DW,45,17,28,21
L6  5EA,L6,5EA,55,28,27,43
L6  5ED,L6,5ED,7,6,1,5
L6  5EG,L6,5EG,11,9,2,3
L6  5EH,L6,5EH,2,1,1,2
L6  5ES,L6,5ES,26,8,18,10
L6  5HT,L6,5HT,32,14,18,13
L6  5HU,L6,5HU,40,26,14,32
L6  5HX,L6,5HX,76,42,34,60
L6  5JN,L6,5JN,35,19,16,14
L6  5JP,L6,5JP,130,71,59,76
L6  5JR,L6,5JR,58,27,31,23
L6  5JS,L6,5JS,25,21,4,16
L6  5JT,L6,5JT,23,15,8,15
L6  5JU,L6,5JU,9,3,6,7
L6  5JW,L6,5JW,37,17,20,15
L6  5JY,L6,5JY,86,46,40,44
L6  5LA,L6,5LA,51,27,24,47
L6  5LG,L6,5LG,152,71,81,84
L6  5LH,L6,5LH,52,26,26,18
L6  5LL,L6,5LL,32,15,17,12
L6  5LN,L6,5LN,32,19,13,12
L6  5LP,L6,5LP,92,39,53,38
L6  5LQ,L6,5LQ,56,28,28,25
L6  5LR,L6,5LR,48,26,22,19
L6  5LS,L6,5LS,39,17,22,15
L6  5LT,L6,5LT,19,9,10,9
L6  5LU,L6,5LU,34,15,19,16
L6  5LW,L6,5LW,66,28,38,34
L6  5LX,L6,5LX,31,16,15,16
L6  5LY,L6,5LY,29,13,16,15
L6  5LZ,L6,5LZ,38,18,20,21
L6  5NA,L6,5NA,69,33,36,39
L6  5NB,L6,5NB,13,8,5,5
L6  5ND,L6,5ND,27,12,15,11
L6  6AA,L6,6AA,19,11,8,12
L6  6AD,L6,6AD,72,35,37,31
L6  6AE,L6,6AE,22,11,11,12
L6  6AG,L6,6AG,62,38,24,36
L6  6AH,L6,6AH,14,6,8,5
L6  6AJ,L6,6AJ,62,29,33,28
L6  6AL,L6,6AL,57,28,29,28
L6  6AN,L6,6AN,25,14,11,14
L6  6AP,L6,6AP,74,42,32,35
L6  6AQ,L6,6AQ,72,30,42,41
L6  6AR,L6,6AR,47,27,20,29
L6  6AS,L6,6AS,85,40,45,33
L6  6AT,L6,6AT,65,40,25,31
L6  6AU,L6,6AU,20,11,9,16
L6  6AW,L6,6AW,66,31,35,33
L6  6AX,L6,6AX,59,27,32,35
L6  6AY,L6,6AY,95,50,45,45
L6  6AZ,L6,6AZ,74,34,40,37
L6  6BA,L6,6BA,72,37,35,41
L6  6BB,L6,6BB,68,35,33,42
L6  6BD,L6,6BD,89,42,47,47
L6  6BE,L6,6BE,87,39,48,29
L6  6BG,L6,6BG,96,61,35,43
L6  6BH,L6,6BH,70,33,37,26
L6  6BJ,L6,6BJ,62,30,32,28
L6  6BL,L6,6BL,69,31,38,26
L6  6BN,L6,6BN,79,35,44,31
L6  6BQ,L6,6BQ,103,53,50,46
L6  6BS,L6,6BS,12,4,8,4
L6  6BT,L6,6BT,2,2,0,2
L6  6BU,L6,6BU,73,40,33,44
L6  6BW,L6,6BW,73,38,35,35
L6  6BX,L6,6BX,99,49,50,47
L6  6BY,L6,6BY,97,47,50,48
L6  6BZ,L6,6BZ,99,57,42,48
L6  6DA,L6,6DA,90,51,39,42
L6  6DB,L6,6DB,89,44,45,42
L6  6DD,L6,6DD,88,43,45,38
L6  6DE,L6,6DE,105,63,42,36
L6  6DF,L6,6DF,92,40,52,38
L6  6DG,L6,6DG,116,53,63,44
L6  6DH,L6,6DH,129,66,63,50
L6  6DJ,L6,6DJ,107,52,55,40
L6  6DL,L6,6DL,13,7,6,7
L6  6DN,L6,6DN,91,37,54,35
L6  6DP,L6,6DP,28,14,14,11
L6  6DQ,L6,6DQ,127,58,69,47
L6  6DW,L6,6DW,49,27,22,19
L6  7UA,L6,7UA,47,30,17,22
L6  7UB,L6,7UB,91,54,37,50
L6  7UD,L6,7UD,53,33,20,24
L6  7UE,L6,7UE,81,48,33,59
L6  7UF,L6,7UF,51,31,20,34
L6  7UG,L6,7UG,111,87,24,78
L6  7UH,L6,7UH,64,34,30,26
L6  7UJ,L6,7UJ,36,25,11,26
L6  7UL,L6,7UL,18,10,8,16
L6  7UP,L6,7UP,85,61,24,56
L6  7UQ,L6,7UQ,73,35,38,39
L6  7UR,L6,7UR,5,4,1,5
L6  7UW,L6,7UW,70,44,26,22
L6  8NA,L6,8NA,39,24,15,11
L6  8NB,L6,8NB,96,68,28,69
L6  8ND,L6,8ND,18,6,12,6
L6  8NE,L6,8NE,47,23,24,35
L6  8NF,L6,8NF,102,60,42,57
L6  8NG,L6,8NG,185,118,67,120
L6  8NH,L6,8NH,31,12,19,10
L6  8NJ,L6,8NJ,57,31,26,28
L6  8NL,L6,8NL,46,16,30,19
L6  8NN,L6,8NN,54,30,24,21
L6  8NP,L6,8NP,117,44,73,46
L6  8NQ,L6,8NQ,82,45,37,29
L6  8NR,L6,8NR,114,52,62,49
L6  8NS,L6,8NS,51,30,21,22
L6  8NT,L6,8NT,50,23,27,23
L6  8NU,L6,8NU,62,32,30,26
L6  8NW,L6,8NW,46,23,23,15
L6  8NX,L6,8NX,53,28,25,22
L6  8NY,L6,8NY,110,53,57,41
L6  8NZ,L6,8NZ,70,33,37,29
L6  8PA,L6,8PA,38,17,21,17
L6  8PB,L6,8PB,46,27,19,18
L6  8PD,L6,8PD,24,11,13,16
L6  8PE,L6,8PE,56,32,24,18
L6  8PF,L6,8PF,36,26,10,11
L6  8PG,L6,8PG,25,15,10,14
L6  8PH,L6,8PH,70,30,40,26
L6  8PJ,L6,8PJ,120,63,57,48
L6  8PQ,L6,8PQ,49,30,19,21
L6  9AB,L6,9AB,52,28,24,19
L6  9AD,L6,9AD,60,26,34,26
L6  9AE,L6,9AE,15,12,3,11
L6  9AG,L6,9AG,67,29,38,35
L6  9AH,L6,9AH,60,34,26,19
L6  9AJ,L6,9AJ,79,37,42,29
L6  9AL,L6,9AL,67,24,43,26
L6  9AY,L6,9AY,54,24,30,24
L6  9BA,L6,9BA,14,8,6,7
L6  9BB,L6,9BB,8,6,2,3
L6  9BD,L6,9BD,43,17,26,17
L6  9BY,L6,9BY,4,1,3,1
L6  9DF,L6,9DF,7,1,6,2
L6  9DG,L6,9DG,33,17,16,12
L6  9DH,L6,9DH,62,31,31,29
L6  9DP,L6,9DP,70,33,37,28
L6  9DT,L6,9DT,5,3,2,3
L6  9DZ,L6,9DZ,28,18,10,19
L6  9ES,L6,9ES,10,6,4,7
L6  9HG,L6,9HG,75,30,45,30
L6  9HR,L6,9HR,33,24,9,26
L6  9HS,L6,9HS,188,94,94,85
L6  9HT,L6,9HT,121,55,66,55
L6  9HU,L6,9HU,49,27,22,17
L6  9HX,L6,9HX,12,10,2,9
L6  9HY,L6,9HY,34,16,18,14
L6  9HZ,L6,9HZ,65,31,34,21
L6  9JA,L6,9JA,9,7,2,8
L6  9JB,L6,9JB,9,3,6,5
L6  9JD,L6,9JD,4,4,0,4
L6  9JE,L6,9JE,49,29,20,22
L6  9JF,L6,9JF,21,13,8,11
L6  9JG,L6,9JG,7,5,2,4
L6  9JH,L6,9JH,29,12,17,10
L6  9JJ,L6,9JJ,49,24,25,21
L6  9JL,L6,9JL,28,11,17,13
L6  9JN,L6,9JN,27,11,16,12
L7  0BA,L7,0BA,22,14,8,14
L7  0EA,L7,0EA,36,16,20,17
L7  0EB,L7,0EB,30,14,16,15
L7  0ED,L7,0ED,38,16,22,15
L7  0EE,L7,0EE,56,35,21,26
L7  0EF,L7,0EF,83,40,43,31
L7  0EG,L7,0EG,43,23,20,20
L7  0EH,L7,0EH,35,20,15,15
L7  0EJ,L7,0EJ,32,11,21,13
L7  0EL,L7,0EL,22,6,16,13
L7  0EN,L7,0EN,105,53,52,42
L7  0EP,L7,0EP,63,36,27,29
L7  0EQ,L7,0EQ,63,28,35,25
L7  0ER,L7,0ER,57,25,32,34
L7  0ES,L7,0ES,73,43,30,27
L7  0ET,L7,0ET,146,74,72,87
L7  0EU,L7,0EU,25,9,16,11
L7  0EW,L7,0EW,56,31,25,23
L7  0HD,L7,0HD,13,6,7,7
L7  0HE,L7,0HE,23,10,13,9
L7  0HF,L7,0HF,30,20,10,9
L7  0HG,L7,0HG,55,32,23,39
L7  0HH,L7,0HH,23,9,14,10
L7  0HJ,L7,0HJ,31,15,16,19
L7  0HN,L7,0HN,9,6,3,5
L7  0HP,L7,0HP,39,22,17,15
L7  0HR,L7,0HR,17,6,11,9
L7  0HT,L7,0HT,83,39,44,32
L7  0HW,L7,0HW,118,57,61,42
L7  0HX,L7,0HX,22,13,9,8
L7  0JA,L7,0JA,17,12,5,13
L7  0JB,L7,0JB,8,4,4,6
L7  0JD,L7,0JD,10,7,3,5
L7  0JE,L7,0JE,69,38,31,40
L7  0JF,L7,0JF,58,31,27,23
L7  0JG,L7,0JG,72,39,33,36
L7  0JH,L7,0JH,72,32,40,36
L7  0JJ,L7,0JJ,76,35,41,34
L7  0JL,L7,0JL,109,58,51,54
L7  0JN,L7,0JN,64,33,31,21
L7  0JP,L7,0JP,101,55,46,37
L7  0JQ,L7,0JQ,65,26,39,30
L7  0JR,L7,0JR,71,38,33,33
L7  0JS,L7,0JS,112,59,53,60
L7  0JT,L7,0JT,71,37,34,32
L7  0JU,L7,0JU,22,11,11,9
L7  0JW,L7,0JW,83,45,38,46
L7  0JX,L7,0JX,86,43,43,39
L7  0JY,L7,0JY,28,13,15,13
L7  0JZ,L7,0JZ,73,39,34,30
L7  0LA,L7,0LA,18,10,8,12
L7  0LB,L7,0LB,20,13,7,9
L7  0LD,L7,0LD,7,2,5,2
L7  0LG,L7,0LG,23,14,9,13
L7  0LH,L7,0LH,52,33,19,27
L7  0LJ,L7,0LJ,9,5,4,6
L7  0LP,L7,0LP,139,75,64,81
L7  0LR,L7,0LR,111,55,56,67
L7  0LS,L7,0LS,54,25,29,46
L7  0LT,L7,0LT,30,24,6,27
L7  0LW,L7,0LW,140,80,60,93
L7  0LY,L7,0LY,34,24,10,27
L7  1PA,L7,1PA,45,19,26,5
L7  1PB,L7,1PB,40,23,17,29
L7  1PD,L7,1PD,17,9,8,10
L7  1PE,L7,1PE,10,7,3,9
L7  1PF,L7,1PF,30,16,14,21
L7  1PG,L7,1PG,4,4,0,4
L7  1PQ,L7,1PQ,14,6,8,9
L7  1PW,L7,1PW,8,2,6,5
L7  1PZ,L7,1PZ,10,4,6,7
L7  1QB,L7,1QB,18,8,10,9
L7  1QD,L7,1QD,21,10,11,10
L7  1QF,L7,1QF,20,12,8,13
L7  1QG,L7,1QG,3,2,1,1
L7  1QH,L7,1QH,32,13,19,12
L7  1QJ,L7,1QJ,15,6,9,11
L7  1QL,L7,1QL,19,10,9,10
L7  1QX,L7,1QX,32,20,12,13
L7  1RB,L7,1RB,15,5,10,7
L7  1RN,L7,1RN,16,3,13,8
L7  2GA,L7,2GA,89,39,50,38
L7  2PF,L7,2PF,15,0,15,0
L7  2PJ,L7,2PJ,15,10,5,6
L7  2PL,L7,2PL,25,13,12,14
L7  2PN,L7,2PN,54,35,19,33
L7  2PR,L7,2PR,45,31,14,28
L7  2PS,L7,2PS,67,36,31,26
L7  2PT,L7,2PT,113,68,45,48
L7  2PU,L7,2PU,64,34,30,33
L7  2PX,L7,2PX,34,20,14,18
L7  2PY,L7,2PY,75,38,37,34
L7  2PZ,L7,2PZ,94,47,47,31
L7  2QA,L7,2QA,11,5,6,8
L7  2QB,L7,2QB,60,30,30,27
L7  2QD,L7,2QD,96,59,37,45
L7  2QE,L7,2QE,94,49,45,38
L7  2QF,L7,2QF,98,50,48,36
L7  2QG,L7,2QG,44,23,21,18
L7  2QH,L7,2QH,30,12,18,16
L7  2QN,L7,2QN,92,37,55,36
L7  2QQ,L7,2QQ,41,20,21,19
L7  2QR,L7,2QR,2,2,0,2
L7  2QS,L7,2QS,29,11,18,18
L7  2QT,L7,2QT,42,26,16,18
L7  2QU,L7,2QU,43,19,24,17
L7  2QX,L7,2QX,21,11,10,8
L7  2QZ,L7,2QZ,46,15,31,18
L7  2RE,L7,2RE,53,32,21,25
L7  2RF,L7,2RF,18,11,7,11
L7  2RG,L7,2RG,9,5,4,7
L7  2RN,L7,2RN,8,3,5,3
L7  2SA,L7,2SA,108,53,55,29
L7  3ED,L7,3ED,17,17,0,4
L7  3EE,L7,3EE,53,22,31,17
L7  3EF,L7,3EF,42,18,24,22
L7  3EG,L7,3EG,70,42,28,15
L7  3EH,L7,3EH,14,12,2,6
L7  3EJ,L7,3EJ,50,38,12,23
L7  3EN,L7,3EN,54,37,17,20
L7  3EQ,L7,3EQ,22,6,16,7
L7  3ES,L7,3ES,8,7,1,2
L7  3ET,L7,3ET,126,51,75,37
L7  3EU,L7,3EU,9,5,4,3
L7  3EW,L7,3EW,46,25,21,8
L7  3EY,L7,3EY,19,8,11,8
L7  3GA,L7,3GA,6,5,1,1
L7  3HD,L7,3HD,6,1,5,1
L7  3HJ,L7,3HJ,16,6,10,6
L7  3HL,L7,3HL,52,21,31,22
L7  3HT,L7,3HT,21,10,11,11
L7  3JE,L7,3JE,43,15,28,18
L7  3JQ,L7,3JQ,52,20,32,23
L7  3JS,L7,3JS,16,8,8,9
L7  3JU,L7,3JU,40,13,27,16
L7  3LA,L7,3LA,236,109,127,11
L7  3LB,L7,3LB,90,53,37,39
L7  3LJ,L7,3LJ,86,32,54,37
L7  3LL,L7,3LL,67,31,36,32
L7  3LN,L7,3LN,4,3,1,4
L7  3LP,L7,3LP,21,11,10,14
L7  3LS,L7,3LS,29,15,14,14
L7  3LT,L7,3LT,40,14,26,14
L7  3LW,L7,3LW,23,11,12,16
L7  3LZ,L7,3LZ,1,0,1,1
L7  3NY,L7,3NY,3,1,2,1
L7  3PD,L7,3PD,7,1,6,2
L7  3PE,L7,3PE,9,6,3,8
L7  3PG,L7,3PG,25,8,17,8
L7  3PP,L7,3PP,50,22,28,22
L7  3QA,L7,3QA,31,9,22,9
L7  3QB,L7,3QB,42,22,20,31
L7  3QD,L7,3QD,135,75,60,78
L7  3QE,L7,3QE,97,52,45,58
L7  3QF,L7,3QF,62,41,21,35
L7  3QG,L7,3QG,42,28,14,37
L7  3QH,L7,3QH,147,95,52,74
L7  3QL,L7,3QL,54,30,24,17
L7  3QN,L7,3QN,23,15,8,12
L7  3QQ,L7,3QQ,17,9,8,9
L7  3QR,L7,3QR,30,15,15,11
L7  3QS,L7,3QS,46,24,22,18
L7  3QT,L7,3QT,22,11,11,8
L7  3QU,L7,3QU,57,22,35,27
L7  3QW,L7,3QW,10,8,2,9
L7  3QX,L7,3QX,34,11,23,14
L7  3QY,L7,3QY,44,16,28,16
L7  3QZ,L7,3QZ,18,5,13,9
L7  3RA,L7,3RA,42,20,22,19
L7  3RB,L7,3RB,24,10,14,18
L7  3RD,L7,3RD,22,10,12,10
L7  3RG,L7,3RG,324,146,178,0
L7  3RH,L7,3RH,58,35,23,32
L7  4JB,L7,4JB,21,14,7,11
L7  4JF,L7,4JF,16,12,4,10
L7  4JG,L7,4JG,27,17,10,16
L7  4JP,L7,4JP,43,21,22,21
L7  4JQ,L7,4JQ,34,21,13,21
L7  4JW,L7,4JW,36,18,18,17
L7  4LA,L7,4LA,25,11,14,6
L7  4LD,L7,4LD,26,12,14,10
L7  4LE,L7,4LE,34,11,23,10
L7  4LF,L7,4LF,51,28,23,16
L7  4LG,L7,4LG,58,30,28,26
L7  4LH,L7,4LH,26,10,16,9
L7  4LN,L7,4LN,21,17,4,17
L7  4LQ,L7,4LQ,39,19,20,17
L7  4LW,L7,4LW,45,26,19,32
L7  5DA,L7,5DA,11,7,4,8
L7  5DB,L7,5DB,50,31,19,13
L7  5NA,L7,5NA,29,14,15,20
L7  5NF,L7,5NF,2,2,0,2
L7  5NG,L7,5NG,23,17,6,15
L7  5NH,L7,5NH,31,6,25,7
L7  5NZ,L7,5NZ,4,2,2,4
L7  5PN,L7,5PN,11,7,4,6
L7  5PX,L7,5PX,95,58,37,66
L7  5PY,L7,5PY,62,48,14,50
L7  5PZ,L7,5PZ,38,27,11,24
L7  5QB,L7,5QB,18,7,11,11
L7  5QD,L7,5QD,26,21,5,18
L7  5QE,L7,5QE,20,12,8,11
L7  5QF,L7,5QF,38,21,17,22
L7  5QG,L7,5QG,34,19,15,14
L7  5QH,L7,5QH,71,44,27,56
L7  5QN,L7,5QN,20,9,11,11
L7  5QP,L7,5QP,12,7,5,7
L7  5QQ,L7,5QQ,18,10,8,10
L7  5QR,L7,5QR,27,17,10,21
L7  5QS,L7,5QS,29,10,19,15
L7  5QT,L7,5QT,31,13,18,13
L7  5QU,L7,5QU,37,21,16,22
L7  5QW,L7,5QW,40,21,19,16
L7  5QX,L7,5QX,22,10,12,11
L7  5QY,L7,5QY,21,12,9,9
L7  5QZ,L7,5QZ,42,32,10,38
L7  5WA,L7,5WA,25,11,14,16
L7  6AA,L7,6AA,34,18,16,12
L7  6AB,L7,6AB,28,15,13,12
L7  6AD,L7,6AD,36,22,14,24
L7  6AE,L7,6AE,23,14,9,10
L7  6AF,L7,6AF,40,22,18,15
L7  6AG,L7,6AG,39,19,20,16
L7  6AH,L7,6AH,39,19,20,13
L7  6AJ,L7,6AJ,36,21,15,15
L7  6AQ,L7,6AQ,92,52,40,37
L7  6AT,L7,6AT,87,42,45,39
L7  6AU,L7,6AU,40,15,25,22
L7  6GA,L7,6GA,1,1,0,1
L7  6HA,L7,6HA,27,13,14,15
L7  6HB,L7,6HB,69,29,40,29
L7  6HD,L7,6HD,9,3,6,3
L7  6HE,L7,6HE,19,17,2,11
L7  6HF,L7,6HF,52,26,26,28
L7  6HG,L7,6HG,40,18,22,20
L7  6HH,L7,6HH,42,28,14,16
L7  6HL,L7,6HL,26,12,14,8
L7  6HQ,L7,6HQ,18,9,9,4
L7  6HY,L7,6HY,75,36,39,31
L7  6JG,L7,6JG,5,3,2,1
L7  6JP,L7,6JP,67,37,30,39
L7  6JS,L7,6JS,40,17,23,16
L7  6JY,L7,6JY,64,32,32,30
L7  6LA,L7,6LA,22,12,10,7
L7  6LB,L7,6LB,14,8,6,6
L7  6LD,L7,6LD,85,38,47,27
L7  6LF,L7,6LF,37,15,22,15
L7  6LG,L7,6LG,78,33,45,22
L7  6LH,L7,6LH,16,8,8,7
L7  6LL,L7,6LL,28,14,14,9
L7  6LP,L7,6LP,32,17,15,12
L7  6LQ,L7,6LQ,14,8,6,7
L7  6LR,L7,6LR,51,29,22,30
L7  6LS,L7,6LS,38,19,19,14
L7  6LU,L7,6LU,14,5,9,10
L7  6LY,L7,6LY,26,12,14,8
L7  6NP,L7,6NP,6,5,1,6
L7  6NR,L7,6NR,19,12,7,15
L7  6NX,L7,6NX,43,19,24,21
L7  6NY,L7,6NY,32,17,15,18
L7  6PA,L7,6PA,25,11,14,16
L7  6PB,L7,6PB,38,17,21,21
L7  6PD,L7,6PD,81,43,38,46
L7  6PX,L7,6PX,47,24,23,17
L7  6PY,L7,6PY,8,7,1,6
L7  6PZ,L7,6PZ,54,25,29,19
L7  6QA,L7,6QA,46,25,21,23
L7  6QB,L7,6QB,34,19,15,20
L7  7AD,L7,7AD,310,176,134,49
L7  7AF,L7,7AF,57,38,19,37
L7  7AG,L7,7AG,256,110,146,26
L7  7AH,L7,7AH,30,16,14,18
L7  7AL,L7,7AL,27,15,12,13
L7  7AU,L7,7AU,54,23,31,0
L7  7AZ,L7,7AZ,63,45,18,35
L7  7BA,L7,7BA,125,77,48,68
L7  7BL,L7,7BL,2,1,1,2
L7  7BT,L7,7BT,31,20,11,20
L7  7BX,L7,7BX,22,14,8,20
L7  7BY,L7,7BY,21,12,9,16
L7  7DA,L7,7DA,82,55,27,49
L7  7DB,L7,7DB,99,61,38,80
L7  7DD,L7,7DD,35,14,21,31
L7  7DL,L7,7DL,71,35,36,48
L7  7DN,L7,7DN,19,12,7,5
L7  7DP,L7,7DP,21,17,4,13
L7  7DX,L7,7DX,4,0,4,4
L7  7EA,L7,7EA,49,27,22,34
L7  7EB,L7,7EB,3,3,0,1
L7  7EE,L7,7EE,108,44,64,23
L7  7EN,L7,7EN,31,15,16,21
L7  7EP,L7,7EP,22,13,9,15
L7  7ER,L7,7ER,43,24,19,27
L7  7ES,L7,7ES,11,9,2,10
L7  7ET,L7,7ET,14,12,2,8
L7  7EU,L7,7EU,28,19,9,25
L7  7EW,L7,7EW,23,13,10,21
L7  7EZ,L7,7EZ,325,163,162,27
L7  7JB,L7,7JB,474,213,261,30
L7  7JD,L7,7JD,19,11,8,10
L7  7JG,L7,7JG,53,23,30,0
L7  7JH,L7,7JH,9,6,3,5
L7  8RA,L7,8RA,129,67,62,60
L7  8RB,L7,8RB,100,55,45,46
L7  8RD,L7,8RD,121,47,74,53
L7  8RE,L7,8RE,91,37,54,35
L7  8RF,L7,8RF,89,51,38,32
L7  8RG,L7,8RG,46,25,21,22
L7  8RH,L7,8RH,21,5,16,9
L7  8RJ,L7,8RJ,38,20,18,18
L7  8RL,L7,8RL,10,6,4,4
L7  8RN,L7,8RN,5,3,2,3
L7  8RP,L7,8RP,108,49,59,36
L7  8RQ,L7,8RQ,64,31,33,32
L7  8RR,L7,8RR,79,41,38,37
L7  8RS,L7,8RS,27,17,10,16
L7  8RT,L7,8RT,57,28,29,23
L7  8RU,L7,8RU,143,85,58,62
L7  8RW,L7,8RW,100,52,48,33
L7  8RX,L7,8RX,67,34,33,26
L7  8RY,L7,8RY,73,34,39,29
L7  8RZ,L7,8RZ,150,71,79,61
L7  8SA,L7,8SA,107,63,44,39
L7  8SD,L7,8SD,106,45,61,32
L7  8SE,L7,8SE,149,96,53,59
L7  8SF,L7,8SF,107,53,54,47
L7  8SG,L7,8SG,90,40,50,33
L7  8SH,L7,8SH,133,65,68,49
L7  8SJ,L7,8SJ,56,25,31,19
L7  8SL,L7,8SL,61,34,27,22
L7  8SN,L7,8SN,115,58,57,39
L7  8SP,L7,8SP,110,53,57,43
L7  8SQ,L7,8SQ,162,80,82,58
L7  8SR,L7,8SR,145,76,69,56
L7  8SS,L7,8SS,131,70,61,45
L7  8SW,L7,8SW,83,35,48,24
L7  8SY,L7,8SY,61,44,17,36
L7  8SZ,L7,8SZ,8,8,0,5
L7  8TD,L7,8TD,44,28,16,20
L7  8TE,L7,8TE,59,35,24,26
L7  8TF,L7,8TF,48,17,31,18
L7  8TS,L7,8TS,54,30,24,15
L7  8TT,L7,8TT,39,21,18,9
L7  8TU,L7,8TU,14,5,9,7
L7  8UE,L7,8UE,26,13,13,16
L7  8UU,L7,8UU,44,28,16,38
L7  8UX,L7,8UX,41,21,20,29
L7  8UY,L7,8UY,9,7,2,5
L7  8XB,L7,8XB,94,71,23,44
L7  8XD,L7,8XD,11,7,4,4
L7  8XE,L7,8XE,11,6,5,5
L7  8XP,L7,8XP,26,14,12,0
L7  9LA,L7,9LA,76,35,41,27
L7  9LB,L7,9LB,20,9,11,12
L7  9LE,L7,9LE,15,1,14,3
L7  9LF,L7,9LF,37,19,18,16
L7  9LG,L7,9LG,8,4,4,5
L7  9LP,L7,9LP,92,46,46,35
L7  9LQ,L7,9LQ,43,25,18,26
L7  9LR,L7,9LR,20,12,8,12
L7  9LS,L7,9LS,23,13,10,9
L7  9LT,L7,9LT,27,13,14,11
L7  9LU,L7,9LU,125,53,72,48
L7  9LX,L7,9LX,45,26,19,18
L7  9LY,L7,9LY,104,53,51,41
L7  9LZ,L7,9LZ,23,13,10,12
L7  9NA,L7,9NA,29,12,17,12
L8  0HA,L8,0HA,78,33,45,21
L8  0PA,L8,0PA,49,27,22,17
L8  0PY,L8,0PY,134,67,67,97
L8  0PZ,L8,0PZ,5,2,3,5
L8  0QB,L8,0QB,27,15,12,11
L8  0QD,L8,0QD,8,8,0,7
L8  0QE,L8,0QE,35,22,13,14
L8  0QF,L8,0QF,40,26,14,13
L8  0QG,L8,0QG,11,3,8,11
L8  0QH,L8,0QH,14,8,6,4
L8  0QL,L8,0QL,19,8,11,9
L8  0QN,L8,0QN,15,10,5,9
L8  0QQ,L8,0QQ,14,12,2,6
L8  0QR,L8,0QR,103,52,51,60
L8  0QS,L8,0QS,96,65,31,69
L8  0QT,L8,0QT,52,22,30,19
L8  0QU,L8,0QU,53,27,26,24
L8  0QX,L8,0QX,76,41,35,40
L8  0QY,L8,0QY,32,15,17,20
L8  0QZ,L8,0QZ,27,11,16,16
L8  0RA,L8,0RA,58,23,35,39
L8  0RB,L8,0RB,88,38,50,44
L8  0RD,L8,0RD,91,54,37,39
L8  0RE,L8,0RE,59,24,35,41
L8  0RF,L8,0RF,63,35,28,41
L8  0RG,L8,0RG,81,48,33,45
L8  0RH,L8,0RH,77,39,38,42
L8  0RJ,L8,0RJ,85,38,47,45
L8  0RL,L8,0RL,97,53,44,38
L8  0RN,L8,0RN,141,75,66,48
L8  0RP,L8,0RP,135,77,58,55
L8  0RQ,L8,0RQ,78,41,37,45
L8  0RR,L8,0RR,153,79,74,58
L8  0RS,L8,0RS,138,68,70,49
L8  0RT,L8,0RT,106,56,50,40
L8  0RU,L8,0RU,97,72,25,71
L8  0RW,L8,0RW,146,81,65,57
L8  0RX,L8,0RX,112,66,46,66
L8  0RY,L8,0RY,42,33,9,29
L8  0RZ,L8,0RZ,92,45,47,26
L8  0SA,L8,0SA,60,33,27,22
L8  0SD,L8,0SD,91,59,32,49
L8  0SE,L8,0SE,129,81,48,58
L8  0SF,L8,0SF,93,52,41,54
L8  0SG,L8,0SG,64,49,15,38
L8  0SH,L8,0SH,106,71,35,64
L8  0SJ,L8,0SJ,86,42,44,31
L8  0SL,L8,0SL,88,50,38,45
L8  0SN,L8,0SN,149,72,77,53
L8  0SP,L8,0SP,11,11,0,9
L8  0SQ,L8,0SQ,149,78,71,51
L8  0SR,L8,0SR,118,57,61,45
L8  0ST,L8,0ST,139,71,68,58
L8  0SU,L8,0SU,27,14,13,23
L8  0SW,L8,0SW,117,60,57,48
L8  0SX,L8,0SX,93,52,41,72
L8  0SY,L8,0SY,112,60,52,63
L8  0SZ,L8,0SZ,109,56,53,64
L8  0TA,L8,0TA,14,7,7,6
L8  0TB,L8,0TB,24,13,11,12
L8  0TD,L8,0TD,32,22,10,16
L8  0TH,L8,0TH,141,77,64,64
L8  0TJ,L8,0TJ,40,32,8,33
L8  0TL,L8,0TL,254,134,120,150
L8  0TN,L8,0TN,44,21,23,14
L8  0TU,L8,0TU,26,11,15,9
L8  0TW,L8,0TW,64,32,32,21
L8  0TX,L8,0TX,26,13,13,11
L8  0TY,L8,0TY,115,58,57,41
L8  0TZ,L8,0TZ,40,16,24,18
L8  0UE,L8,0UE,121,76,45,68
L8  0UF,L8,0UF,133,68,65,73
L8  0UG,L8,0UG,125,63,62,67
L8  0UJ,L8,0UJ,57,37,20,32
L8  0UN,L8,0UN,94,54,40,36
L8  0UQ,L8,0UQ,121,69,52,69
L8  0UR,L8,0UR,1,1,0,1
L8  0UT,L8,0UT,21,10,11,9
L8  0UW,L8,0UW,69,40,29,20
L8  0UX,L8,0UX,119,55,64,41
L8  0UZ,L8,0UZ,5,2,3,1
L8  0WN,L8,0WN,55,27,28,0
L8  0XA,L8,0XA,17,9,8,9
L8  0XF,L8,0XF,83,38,45,29
L8  0XJ,L8,0XJ,8,3,5,7
L8  0XS,L8,0XS,39,25,14,35
L8  0XT,L8,0XT,45,22,23,18
L8  0XU,L8,0XU,74,38,36,17
L8  0XX,L8,0XX,27,11,16,15
L8  0XY,L8,0XY,36,17,19,15
L8  0XZ,L8,0XZ,60,22,38,19
L8  0YA,L8,0YA,42,18,24,15
L8  0YB,L8,0YB,57,26,31,25
L8  0YD,L8,0YD,2,2,0,2
L8  0YE,L8,0YE,34,17,17,11
L8  0YF,L8,0YF,51,21,30,20
L8  0YG,L8,0YG,47,20,27,14
L8  0YH,L8,0YH,10,5,5,8
L8  0YQ,L8,0YQ,8,4,4,4
L8  1ST,L8,1ST,51,27,24,18
L8  1SU,L8,1SU,18,10,8,12
L8  1SX,L8,1SX,31,12,19,11
L8  1SY,L8,1SY,31,13,18,11
L8  1TD,L8,1TD,27,17,10,14
L8  1TE,L8,1TE,76,38,38,48
L8  1TG,L8,1TG,6,3,3,5
L8  1TH,L8,1TH,90,54,36,64
L8  1TL,L8,1TL,14,10,4,9
L8  1TN,L8,1TN,28,21,7,10
L8  1TP,L8,1TP,68,31,37,21
L8  1TS,L8,1TS,36,19,17,25
L8  1UJ,L8,1UJ,13,6,7,7
L8  1UL,L8,1UL,85,37,48,35
L8  1UN,L8,1UN,9,6,3,3
L8  1UW,L8,1UW,56,30,26,22
L8  1XB,L8,1XB,23,15,8,15
L8  1XE,L8,1XE,16,7,9,11
L8  1XF,L8,1XF,70,34,36,43
L8  1XH,L8,1XH,25,15,10,6
L8  1XY,L8,1XY,43,22,21,14
L8  1YB,L8,1YB,46,17,29,21
L8  1YD,L8,1YD,63,37,26,21
L8  1YE,L8,1YE,74,41,33,27
L8  1YP,L8,1YP,64,27,37,35
L8  1YQ,L8,1YQ,62,28,34,15
L8  1YS,L8,1YS,87,36,51,37
L8  1YT,L8,1YT,87,37,50,38
L8  1YU,L8,1YU,31,15,16,11
L8  1YW,L8,1YW,92,48,44,40
L8  1YX,L8,1YX,14,8,6,7
L8  1YY,L8,1YY,48,26,22,31
L8  2TA,L8,2TA,98,68,30,74
L8  2TB,L8,2TB,78,53,25,45
L8  2TD,L8,2TD,88,42,46,32
L8  2TF,L8,2TF,119,53,66,38
L8  2TG,L8,2TG,97,50,47,35
L8  2TJ,L8,2TJ,26,16,10,11
L8  2TN,L8,2TN,50,24,26,14
L8  2TU,L8,2TU,56,30,26,29
L8  2TX,L8,2TX,46,27,19,20
L8  2TY,L8,2TY,5,4,1,2
L8  2UA,L8,2UA,23,10,13,10
L8  2UF,L8,2UF,26,8,18,13
L8  2UL,L8,2UL,163,101,62,101
L8  2UN,L8,2UN,11,5,6,4
L8  2UP,L8,2UP,85,56,29,66
L8  2UQ,L8,2UQ,9,5,4,4
L8  2US,L8,2US,2,2,0,2
L8  2UU,L8,2UU,22,10,12,7
L8  2UW,L8,2UW,12,2,10,8
L8  2UX,L8,2UX,99,40,59,32
L8  2UY,L8,2UY,26,12,14,11
L8  2XA,L8,2XA,56,33,23,18
L8  2XD,L8,2XD,38,18,20,22
L8  2XG,L8,2XG,49,23,26,15
L8  2XH,L8,2XH,23,11,12,10
L8  2XP,L8,2XP,141,51,90,47
L8  2XQ,L8,2XQ,89,46,43,31
L8  2XS,L8,2XS,61,25,36,20
L8  2XU,L8,2XU,94,41,53,34
L8  2XW,L8,2XW,16,7,9,7
L8  2XX,L8,2XX,22,14,8,11
L8  2XY,L8,2XY,36,21,15,31
L8  2YA,L8,2YA,44,20,24,15
L8  2YB,L8,2YB,29,10,19,11
L8  2YD,L8,2YD,13,8,5,6
L8  2YE,L8,2YE,44,21,23,21
L8  2YF,L8,2YF,62,29,33,24
L8  2YG,L8,2YG,41,18,23,18
L8  3RZ,L8,3RZ,31,18,13,22
L8  3SA,L8,3SA,77,30,47,43
L8  3SB,L8,3SB,36,19,17,19
L8  3SD,L8,3SD,126,67,59,72
L8  3SE,L8,3SE,126,72,54,43
L8  3SF,L8,3SF,142,88,54,107
L8  3SG,L8,3SG,46,24,22,31
L8  3SH,L8,3SH,18,12,6,15
L8  3SJ,L8,3SJ,31,18,13,17
L8  3SL,L8,3SL,157,85,72,65
L8  3SN,L8,3SN,21,20,1,20
L8  3SP,L8,3SP,24,10,14,14
L8  3SQ,L8,3SQ,118,72,46,55
L8  3SR,L8,3SR,100,43,57,60
L8  3SS,L8,3SS,147,75,72,75
L8  3SU,L8,3SU,66,37,29,36
L8  3SX,L8,3SX,26,12,14,20
L8  3SY,L8,3SY,91,51,40,47
L8  3SZ,L8,3SZ,72,44,28,45
L8  3TA,L8,3TA,24,15,9,18
L8  3TB,L8,3TB,9,8,1,9
L8  3TD,L8,3TD,129,85,44,82
L8  3TE,L8,3TE,15,9,6,11
L8  3TF,L8,3TF,27,12,15,11
L8  3TG,L8,3TG,153,102,51,104
L8  3TH,L8,3TH,28,18,10,18
L8  3TJ,L8,3TJ,64,30,34,27
L8  3TL,L8,3TL,77,43,34,25
L8  3TN,L8,3TN,34,15,19,15
L8  3TP,L8,3TP,32,16,16,15
L8  3TQ,L8,3TQ,86,54,32,60
L8  3TS,L8,3TS,4,0,4,2
L8  3TT,L8,3TT,7,4,3,2
L8  3TX,L8,3TX,89,56,33,65
L8  3TY,L8,3TY,139,85,54,81
L8  3TZ,L8,3TZ,104,68,36,71
L8  3UE,L8,3UE,57,33,24,41
L8  3UF,L8,3UF,45,18,27,20
L8  3UG,L8,3UG,36,16,20,15
L8  3UJ,L8,3UJ,91,60,31,70
L8  3UQ,L8,3UQ,27,10,17,7
L8  3UR,L8,3UR,111,60,51,45
L8  3US,L8,3US,28,16,12,11
L8  4AB,L8,4AB,49,25,24,21
L8  4BP,L8,4BP,21,11,10,10
L8  4PB,L8,4PB,19,7,12,8
L8  4PF,L8,4PF,53,28,25,30
L8  4PL,L8,4PL,27,12,15,23
L8  4PN,L8,4PN,29,18,11,12
L8  4PW,L8,4PW,102,50,52,48
L8  4PX,L8,4PX,62,36,26,29
L8  4QL,L8,4QL,3,0,3,3
L8  4QN,L8,4QN,43,27,16,15
L8  4QQ,L8,4QQ,15,7,8,7
L8  4QR,L8,4QR,13,9,4,8
L8  4QU,L8,4QU,24,12,12,10
L8  4QX,L8,4QX,67,32,35,36
L8  4QY,L8,4QY,13,11,2,9
L8  4RB,L8,4RB,2,1,1,1
L8  4RD,L8,4RD,56,27,29,22
L8  4RG,L8,4RG,69,42,27,39
L8  4RR,L8,4RR,53,23,30,23
L8  4RS,L8,4RS,63,29,34,42
L8  4RT,L8,4RT,81,34,47,47
L8  4RU,L8,4RU,82,35,47,48
L8  4RX,L8,4RX,96,42,54,47
L8  4SA,L8,4SA,86,48,38,45
L8  4SB,L8,4SB,86,37,49,48
L8  4SF,L8,4SF,69,35,34,38
L8  4SN,L8,4SN,11,6,5,6
L8  4SQ,L8,4SQ,3,1,2,3
L8  4SS,L8,4SS,53,19,34,17
L8  4SW,L8,4SW,37,18,19,13
L8  4SY,L8,4SY,112,50,62,46
L8  4SZ,L8,4SZ,110,52,58,46
L8  4TD,L8,4TD,23,9,14,10
L8  4TF,L8,4TF,170,84,86,63
L8  4TG,L8,4TG,96,38,58,44
L8  4TH,L8,4TH,112,39,73,49
L8  4TJ,L8,4TJ,112,47,65,47
L8  4TL,L8,4TL,171,82,89,73
L8  4TN,L8,4TN,87,41,46,41
L8  4TQ,L8,4TQ,94,44,50,49
L8  4TW,L8,4TW,75,39,36,41
L8  4TX,L8,4TX,119,65,54,62
L8  4UA,L8,4UA,53,42,11,38
L8  4UB,L8,4UB,20,12,8,9
L8  4UD,L8,4UD,17,9,8,7
L8  4UE,L8,4UE,16,8,8,10
L8  4UH,L8,4UH,26,13,13,11
L8  4UN,L8,4UN,102,59,43,64
L8  4UP,L8,4UP,33,14,19,13
L8  4UR,L8,4UR,37,18,19,16
L8  4UT,L8,4UT,18,12,6,8
L8  4UX,L8,4UX,6,4,2,4
L8  4XE,L8,4XE,54,22,32,24
L8  4XH,L8,4XH,90,36,54,44
L8  4XJ,L8,4XJ,14,6,8,6
L8  4XL,L8,4XL,14,7,7,7
L8  4XN,L8,4XN,25,14,11,13
L8  4XP,L8,4XP,41,16,25,19
L8  4XR,L8,4XR,51,23,28,19
L8  4XT,L8,4XT,14,9,5,10
L8  4XW,L8,4XW,18,12,6,16
L8  4XX,L8,4XX,16,5,11,8
L8  4YB,L8,4YB,13,5,8,6
L8  4YD,L8,4YD,18,9,9,7
L8  4YE,L8,4YE,9,4,5,4
L8  4YF,L8,4YF,19,6,13,10
L8  4YG,L8,4YG,66,41,25,34
L8  4YH,L8,4YH,18,9,9,7
L8  4YJ,L8,4YJ,19,10,9,7
L8  4YL,L8,4YL,42,18,24,20
L8  4YN,L8,4YN,23,12,11,9
L8  4YP,L8,4YP,24,16,8,13
L8  4YQ,L8,4YQ,52,23,29,21
L8  4YR,L8,4YR,18,8,10,9
L8  4YS,L8,4YS,62,33,29,31
L8  4YT,L8,4YT,57,42,15,42
L8  4YU,L8,4YU,29,14,15,16
L8  4YW,L8,4YW,18,10,8,11
L8  5RA,L8,5RA,14,7,7,5
L8  5RD,L8,5RD,18,7,11,17
L8  5RE,L8,5RE,20,15,5,14
L8  5RH,L8,5RH,14,7,7,8
L8  5RJ,L8,5RJ,14,8,6,8
L8  5RL,L8,5RL,43,18,25,22
L8  5RS,L8,5RS,87,47,40,51
L8  5RW,L8,5RW,32,17,15,19
L8  5RX,L8,5RX,55,28,27,36
L8  5SE,L8,5SE,14,9,5,11
L8  5SX,L8,5SX,34,17,17,14
L8  5SY,L8,5SY,1,1,0,1
L8  5TA,L8,5TA,128,66,62,76
L8  5TB,L8,5TB,41,25,16,30
L8  5TD,L8,5TD,33,19,14,22
L8  5TJ,L8,5TJ,94,50,44,43
L8  5TL,L8,5TL,92,40,52,38
L8  5TN,L8,5TN,58,27,31,34
L8  5TP,L8,5TP,81,38,43,34
L8  5TR,L8,5TR,4,1,3,2
L8  5TS,L8,5TS,10,4,6,4
L8  5TW,L8,5TW,82,44,38,42
L8  5UA,L8,5UA,5,3,2,2
L8  5UB,L8,5UB,34,13,21,14
L8  5UL,L8,5UL,33,14,19,16
L8  5UN,L8,5UN,25,9,16,11
L8  5UR,L8,5UR,23,9,14,8
L8  5US,L8,5US,7,4,3,5
L8  5UT,L8,5UT,6,5,1,5
L8  5UW,L8,5UW,35,19,16,14
L8  5UX,L8,5UX,3,2,1,1
L8  5UY,L8,5UY,12,9,3,10
L8  5XE,L8,5XE,71,32,39,31
L8  5XF,L8,5XF,20,9,11,8
L8  5XG,L8,5XG,116,60,56,46
L8  5XH,L8,5XH,29,14,15,26
L8  5XL,L8,5XL,19,8,11,12
L8  5XP,L8,5XP,19,7,12,10
L8  5XQ,L8,5XQ,31,16,15,13
L8  5XU,L8,5XU,31,16,15,18
L8  5XW,L8,5XW,66,22,44,0
L8  5XX,L8,5XX,23,9,14,10
L8  6PA,L8,6PA,22,8,14,7
L8  6PB,L8,6PB,13,6,7,4
L8  6QB,L8,6QB,5,3,2,3
L8  6QE,L8,6QE,12,4,8,6
L8  6QF,L8,6QF,32,15,17,14
L8  6QH,L8,6QH,1,0,1,1
L8  6QL,L8,6QL,10,6,4,4
L8  6QN,L8,6QN,12,11,1,10
L8  6QR,L8,6QR,21,11,10,15
L8  6QW,L8,6QW,23,10,13,10
L8  6RB,L8,6RB,84,36,48,38
L8  6RD,L8,6RD,101,38,63,39
L8  6RE,L8,6RE,30,17,13,14
L8  6RG,L8,6RG,101,43,58,32
L8  6RN,L8,6RN,38,19,19,20
L8  6RQ,L8,6RQ,73,36,37,34
L8  6RT,L8,6RT,22,12,10,6
L8  6RU,L8,6RU,10,5,5,3
L8  6RW,L8,6RW,54,23,31,24
L8  6RX,L8,6RX,41,23,18,18
L8  6RY,L8,6RY,154,76,78,85
L8  6SE,L8,6SE,11,10,1,7
L8  6SH,L8,6SH,25,17,8,9
L8  6SL,L8,6SL,26,10,16,13
L8  6SN,L8,6SN,32,15,17,15
L8  6SR,L8,6SR,39,19,20,15
L8  6SS,L8,6SS,37,16,21,19
L8  6SX,L8,6SX,32,14,18,20
L8  6SY,L8,6SY,68,38,30,39
L8  6TA,L8,6TA,76,39,37,24
L8  6TG,L8,6TG,38,17,21,14
L8  6TN,L8,6TN,57,30,27,29
L8  6TP,L8,6TP,15,7,8,7
L8  6TQ,L8,6TQ,26,11,15,11
L8  6TR,L8,6TR,48,23,25,20
L8  6TS,L8,6TS,31,15,16,16
L8  6TT,L8,6TT,64,26,38,25
L8  6TW,L8,6TW,40,21,19,22
L8  6TX,L8,6TX,20,8,12,8
L8  6UA,L8,6UA,29,15,14,8
L8  6UD,L8,6UD,37,27,10,23
L8  6UG,L8,6UG,68,25,43,23
L8  6UH,L8,6UH,9,5,4,7
L8  6UJ,L8,6UJ,60,41,19,47
L8  6UL,L8,6UL,18,9,9,12
L8  6UN,L8,6UN,11,5,6,9
L8  6UR,L8,6UR,16,6,10,7
L8  6UT,L8,6UT,98,42,56,40
L8  6UW,L8,6UW,12,4,8,3
L8  6UY,L8,6UY,129,60,69,52
L8  6UZ,L8,6UZ,38,20,18,17
L8  6XA,L8,6XA,36,18,18,16
L8  6XB,L8,6XB,18,5,13,9
L8  6XD,L8,6XD,69,29,40,24
L8  6XE,L8,6XE,50,27,23,21
L8  6XF,L8,6XF,19,5,14,9
L8  6XG,L8,6XG,62,30,32,29
L8  6XH,L8,6XH,67,30,37,27
L8  6XN,L8,6XN,39,19,20,16
L8  6XR,L8,6XR,5,2,3,3
L8  6XW,L8,6XW,72,28,44,22
L8  7BA,L8,7BA,1,1,0,1
L8  7BB,L8,7BB,43,31,12,30
L8  7BD,L8,7BD,87,55,32,51
L8  7BE,L8,7BE,64,37,27,34
L8  7GA,L8,7GA,7,6,1,3
L8  7JU,L8,7JU,41,21,20,35
L8  7JX,L8,7JX,234,139,95,67
L8  7JY,L8,7JY,55,33,22,33
L8  7JZ,L8,7JZ,280,141,139,243
L8  7LB,L8,7LB,64,40,24,45
L8  7LD,L8,7LD,109,68,41,73
L8  7LF,L8,7LF,66,34,32,52
L8  7LG,L8,7LG,76,40,36,60
L8  7LH,L8,7LH,25,8,17,10
L8  7LL,L8,7LL,18,12,6,12
L8  7LN,L8,7LN,50,27,23,32
L8  7LP,L8,7LP,34,18,16,22
L8  7LQ,L8,7LQ,47,28,19,29
L8  7LR,L8,7LR,134,84,50,99
L8  7LS,L8,7LS,79,49,30,55
L8  7LT,L8,7LT,100,62,38,69
L8  7LU,L8,7LU,83,47,36,54
L8  7LW,L8,7LW,87,58,29,54
L8  7LX,L8,7LX,13,10,3,9
L8  7LY,L8,7LY,113,66,47,64
L8  7NA,L8,7NA,7,3,4,4
L8  7NB,L8,7NB,23,16,7,21
L8  7NE,L8,7NE,122,72,50,76
L8  7NG,L8,7NG,33,20,13,27
L8  7NH,L8,7NH,60,34,26,44
L8  7NL,L8,7NL,29,20,9,19
L8  7NN,L8,7NN,118,65,53,73
L8  7NP,L8,7NP,151,98,53,69
L8  7NR,L8,7NR,73,45,28,48
L8  7NS,L8,7NS,49,36,13,33
L8  7NT,L8,7NT,44,28,16,31
L8  7NU,L8,7NU,57,40,17,44
L8  7NW,L8,7NW,77,51,26,54
L8  7NY,L8,7NY,62,38,24,31
L8  7NZ,L8,7NZ,94,45,49,65
L8  7PA,L8,7PA,23,10,13,13
L8  7PB,L8,7PB,15,8,7,11
L8  7PE,L8,7PE,16,11,5,11
L8  7PJ,L8,7PJ,26,18,8,14
L8  7PL,L8,7PL,107,52,55,59
L8  7PP,L8,7PP,6,6,0,1
L8  7PQ,L8,7PQ,46,46,0,0
L8  7PU,L8,7PU,25,15,10,22
L8  7PY,L8,7PY,18,13,5,13
L8  7PZ,L8,7PZ,76,41,35,44
L8  7QA,L8,7QA,115,62,53,61
L8  7QE,L8,7QE,37,25,12,26
L8  7QL,L8,7QL,33,20,13,23
L8  7SD,L8,7SD,303,155,148,134
L8  7SE,L8,7SE,12,9,3,12
L8  7SP,L8,7SP,3,2,1,2
L8  7SQ,L8,7SQ,54,24,30,30
L8  7SR,L8,7SR,53,34,19,36
L8  7ST,L8,7ST,110,51,59,40
L8  7SU,L8,7SU,118,62,56,41
L8  7SY,L8,7SY,20,13,7,16
L8  7SZ,L8,7SZ,31,22,9,0
L8  7TA,L8,7TA,35,26,9,22
L8  8AD,L8,8AD,105,69,36,77
L8  8AE,L8,8AE,49,25,24,19
L8  8AF,L8,8AF,31,17,14,8
L8  8AG,L8,8AG,75,36,39,47
L8  8AH,L8,8AH,89,50,39,36
L8  8AJ,L8,8AJ,15,8,7,9
L8  8AL,L8,8AL,41,23,18,14
L8  8AN,L8,8AN,85,47,38,39
L8  8AP,L8,8AP,131,60,71,42
L8  8AQ,L8,8AQ,47,17,30,23
L8  8AT,L8,8AT,69,35,34,29
L8  8AW,L8,8AW,95,45,50,46
L8  8AY,L8,8AY,65,34,31,27
L8  8AZ,L8,8AZ,38,20,18,18
L8  8BG,L8,8BG,12,6,6,5
L8  8BH,L8,8BH,100,35,65,23
L8  8BJ,L8,8BJ,24,12,12,8
L8  8BL,L8,8BL,116,63,53,67
L8  8BN,L8,8BN,72,37,35,28
L8  8BR,L8,8BR,30,15,15,13
L8  8BS,L8,8BS,122,48,74,56
L8  8BT,L8,8BT,110,55,55,47
L8  8BU,L8,8BU,3,1,2,1
L8  8BW,L8,8BW,22,10,12,10
L8  8BX,L8,8BX,23,13,10,16
L8  8DA,L8,8DA,22,12,10,15
L8  8DB,L8,8DB,18,9,9,16
L8  8DD,L8,8DD,19,12,7,13
L8  8DH,L8,8DH,42,22,20,24
L8  8DJ,L8,8DJ,34,20,14,11
L8  8DL,L8,8DL,14,8,6,5
L8  8DX,L8,8DX,2,2,0,2
L8  8EF,L8,8EF,37,16,21,19
L8  8EG,L8,8EG,15,6,9,9
L8  8EH,L8,8EH,26,19,7,19
L8  8EN,L8,8EN,47,26,21,18
L8  8EQ,L8,8EQ,45,25,20,18
L8  8EY,L8,8EY,102,49,53,48
L8  8EZ,L8,8EZ,109,48,61,42
L8  8HD,L8,8HD,70,43,27,31
L8  8HE,L8,8HE,202,95,107,56
L8  8HG,L8,8HG,96,46,50,42
L8  8HL,L8,8HL,41,12,29,14
L8  8HN,L8,8HN,109,57,52,51
L8  8HQ,L8,8HQ,96,51,45,38
L8  8HT,L8,8HT,62,25,37,29
L8  8HU,L8,8HU,96,47,49,40
L8  8HW,L8,8HW,73,37,36,32
L8  8HX,L8,8HX,59,29,30,24
L8  8HY,L8,8HY,55,32,23,24
L8  8HZ,L8,8HZ,81,37,44,33
L8  8JA,L8,8JA,23,6,17,6
L8  8JD,L8,8JD,19,13,6,16
L8  8JT,L8,8JT,22,10,12,13
L8  8JW,L8,8JW,26,13,13,17
L8  8JY,L8,8JY,45,21,24,22
L8  8JZ,L8,8JZ,41,14,27,20
L8  8LA,L8,8LA,87,40,47,39
L8  8LB,L8,8LB,28,6,22,17
L8  8LD,L8,8LD,57,21,36,33
L8  8LF,L8,8LF,39,18,21,17
L8  8LG,L8,8LG,15,8,7,13
L8  8LH,L8,8LH,37,16,21,13
L8  8LJ,L8,8LJ,31,14,17,12
L8  8LL,L8,8LL,57,21,36,22
L8  8LN,L8,8LN,60,23,37,23
L8  8LQ,L8,8LQ,31,15,16,15
L8  8LR,L8,8LR,57,27,30,23
L8  8LS,L8,8LS,43,24,19,22
L8  8LT,L8,8LT,65,31,34,24
L8  8LU,L8,8LU,32,17,15,28
L8  8LX,L8,8LX,29,19,10,19
L8  8LY,L8,8LY,15,11,4,10
L8  8ND,L8,8ND,78,35,43,41
L8  8NE,L8,8NE,56,26,30,19
L8  8NF,L8,8NF,99,46,53,31
L8  9RE,L8,9RE,11,6,5,3
L8  9RF,L8,9RF,2,0,2,1
L8  9RL,L8,9RL,13,6,7,7
L8  9RN,L8,9RN,60,60,0,1
L8  9RP,L8,9RP,41,27,14,26
L8  9RR,L8,9RR,40,18,22,18
L8  9RS,L8,9RS,83,37,46,32
L8  9RT,L8,9RT,4,2,2,2
L8  9RU,L8,9RU,55,31,24,25
L8  9RW,L8,9RW,103,52,51,41
L8  9RX,L8,9RX,77,39,38,36
L8  9RY,L8,9RY,46,22,24,22
L8  9RZ,L8,9RZ,49,24,25,16
L8  9SA,L8,9SA,36,17,19,18
L8  9SB,L8,9SB,4,1,3,2
L8  9SD,L8,9SD,94,41,53,48
L8  9SH,L8,9SH,106,57,49,53
L8  9SJ,L8,9SJ,44,18,26,28
L8  9SN,L8,9SN,19,9,10,7
L8  9SP,L8,9SP,44,19,25,27
L8  9SR,L8,9SR,48,28,20,28
L8  9SS,L8,9SS,48,30,18,26
L8  9ST,L8,9ST,38,17,21,26
L8  9SU,L8,9SU,21,9,12,11
L8  9SX,L8,9SX,58,28,30,30
L8  9TA,L8,9TA,73,34,39,34
L8  9TB,L8,9TB,83,33,50,36
L8  9TD,L8,9TD,63,31,32,30
L8  9TH,L8,9TH,59,23,36,22
L8  9TJ,L8,9TJ,49,28,21,29
L8  9UB,L8,9UB,42,19,23,21
L8  9UN,L8,9UN,5,0,5,3
L8  9UR,L8,9UR,70,29,41,32
L8  9US,L8,9US,74,30,44,43
L8  9UU,L8,9UU,67,32,35,41
L8  9UX,L8,9UX,100,47,53,49
L8  9XD,L8,9XD,32,12,20,30
L8  9XP,L8,9XP,117,60,57,45
L8  9XS,L8,9XS,123,61,62,49
L8  9XT,L8,9XT,45,23,22,18
L8  9XU,L8,9XU,69,30,39,28
L8  9XX,L8,9XX,61,42,19,55
L8  9XY,L8,9XY,54,31,23,19
L8  9XZ,L8,9XZ,18,7,11,11
L8  9YA,L8,9YA,85,41,44,32
L8  9YB,L8,9YB,30,12,18,12
L8  9YD,L8,9YD,24,8,16,9
L8  9YE,L8,9YE,12,4,8,3
L8  9YG,L8,9YG,148,60,88,61
L8  9ZA,L8,9ZA,25,11,14,11
L8  9ZB,L8,9ZB,29,16,13,15
L8  9ZD,L8,9ZD,52,24,28,35
L9  0EA,L9,0EA,38,18,20,23
L9  0ED,L9,0ED,23,14,9,11
L9  0EH,L9,0EH,1,1,0,1
L9  0EJ,L9,0EJ,35,21,14,19
L9  0EL,L9,0EL,59,36,23,32
L9  0EN,L9,0EN,17,9,8,7
L9  0EP,L9,0EP,13,7,6,6
L9  0ER,L9,0ER,67,36,31,21
L9  0ES,L9,0ES,17,7,10,4
L9  0ET,L9,0ET,26,11,15,12
L9  0EU,L9,0EU,28,16,12,12
L9  0EX,L9,0EX,66,31,35,20
L9  0EY,L9,0EY,59,32,27,29
L9  0EZ,L9,0EZ,78,42,36,40
L9  0HA,L9,0HA,26,12,14,12
L9  0HD,L9,0HD,84,37,47,34
L9  0HE,L9,0HE,36,19,17,14
L9  0HF,L9,0HF,70,31,39,24
L9  0HG,L9,0HG,57,28,29,22
L9  0HH,L9,0HH,95,44,51,39
L9  0HJ,L9,0HJ,84,39,45,37
L9  0HL,L9,0HL,81,34,47,36
L9  0HN,L9,0HN,13,8,5,10
L9  0HQ,L9,0HQ,48,24,24,21
L9  0HR,L9,0HR,52,24,28,29
L9  0HT,L9,0HT,89,38,51,39
L9  0HU,L9,0HU,19,9,10,10
L9  0HX,L9,0HX,38,25,13,19
L9  0HY,L9,0HY,23,17,6,12
L9  0HZ,L9,0HZ,32,19,13,14
L9  0JD,L9,0JD,21,8,13,9
L9  0JE,L9,0JE,119,64,55,48
L9  0JF,L9,0JF,43,13,30,19
L9  0JH,L9,0JH,39,19,20,23
L9  0JJ,L9,0JJ,25,11,14,13
L9  0JL,L9,0JL,15,8,7,10
L9  0JN,L9,0JN,95,45,50,44
L9  0JP,L9,0JP,23,8,15,14
L9  0JQ,L9,0JQ,76,33,43,34
L9  0JR,L9,0JR,51,29,22,23
L9  0JS,L9,0JS,86,42,44,38
L9  0JT,L9,0JT,26,11,15,13
L9  0JU,L9,0JU,45,28,17,18
L9  0JW,L9,0JW,54,25,29,29
L9  0JX,L9,0JX,35,20,15,15
L9  0JY,L9,0JY,60,33,27,32
L9  0JZ,L9,0JZ,79,41,38,43
L9  0LA,L9,0LA,52,25,27,18
L9  0LB,L9,0LB,25,11,14,14
L9  0LD,L9,0LD,7,4,3,2
L9  0LE,L9,0LE,62,31,31,19
L9  0LF,L9,0LF,34,14,20,16
L9  0LG,L9,0LG,63,27,36,30
L9  0LH,L9,0LH,47,25,22,22
L9  0LJ,L9,0LJ,33,17,16,14
L9  0LL,L9,0LL,28,11,17,13
L9  0LN,L9,0LN,31,17,14,15
L9  0LP,L9,0LP,64,34,30,26
L9  0LQ,L9,0LQ,71,37,34,28
L9  0LR,L9,0LR,90,38,52,39
L9  0LS,L9,0LS,48,23,25,17
L9  0LT,L9,0LT,6,3,3,2
L9  0LU,L9,0LU,28,15,13,10
L9  0LW,L9,0LW,51,27,24,22
L9  0LX,L9,0LX,38,22,16,18
L9  0LY,L9,0LY,12,6,6,6
L9  0NA,L9,0NA,53,27,26,21
L9  0NB,L9,0NB,88,46,42,36
L9  0ND,L9,0ND,82,46,36,28
L9  0NE,L9,0NE,14,6,8,5
L9  0NF,L9,0NF,12,6,6,7
L9  0NG,L9,0NG,11,4,7,8
L9  0NL,L9,0NL,32,16,16,11
L9  0NQ,L9,0NQ,77,37,40,31
L9  0NT,L9,0NT,39,18,21,13
L9  0NU,L9,0NU,52,21,31,21
L9  0NW,L9,0NW,32,16,16,10
L9  0NX,L9,0NX,72,36,36,26
L9  0NY,L9,0NY,40,19,21,14
L9  0NZ,L9,0NZ,26,11,15,10
L9  0PA,L9,0PA,41,19,22,14
L9  0PF,L9,0PF,42,22,20,18
L9  0PG,L9,0PG,7,6,1,4
L9  1AA,L9,1AA,25,11,14,12
L9  1AB,L9,1AB,36,25,11,18
L9  1AD,L9,1AD,20,11,9,9
L9  1AF,L9,1AF,51,41,10,33
L9  1AG,L9,1AG,55,22,33,23
L9  1AJ,L9,1AJ,110,57,53,40
L9  1AL,L9,1AL,98,55,43,38
L9  1AN,L9,1AN,121,51,70,46
L9  1AQ,L9,1AQ,13,9,4,7
L9  1AS,L9,1AS,73,37,36,24
L9  1AT,L9,1AT,92,59,33,49
L9  1AU,L9,1AU,29,20,9,11
L9  1AW,L9,1AW,85,47,38,42
L9  1AX,L9,1AX,109,67,42,60
L9  1AY,L9,1AY,82,61,21,62
L9  1BG,L9,1BG,60,24,36,26
L9  1BH,L9,1BH,60,29,31,24
L9  1BJ,L9,1BJ,55,27,28,25
L9  1BN,L9,1BN,50,20,30,18
L9  1BP,L9,1BP,9,4,5,5
L9  1BQ,L9,1BQ,66,29,37,30
L9  1BS,L9,1BS,38,15,23,17
L9  1BT,L9,1BT,88,48,40,27
L9  1BU,L9,1BU,94,48,46,30
L9  1BW,L9,1BW,46,22,24,23
L9  1BX,L9,1BX,50,31,19,21
L9  1BY,L9,1BY,65,33,32,29
L9  1BZ,L9,1BZ,66,37,29,30
L9  1DA,L9,1DA,13,8,5,9
L9  1DB,L9,1DB,28,20,8,11
L9  1DD,L9,1DD,58,32,26,24
L9  1DJ,L9,1DJ,44,29,15,27
L9  1DL,L9,1DL,68,30,38,33
L9  1DP,L9,1DP,77,38,39,34
L9  1DX,L9,1DX,99,45,54,51
L9  1DY,L9,1DY,46,21,25,24
L9  1DZ,L9,1DZ,69,40,29,30
L9  1EA,L9,1EA,86,42,44,46
L9  1EB,L9,1EB,94,48,46,51
L9  1ED,L9,1ED,19,9,10,10
L9  1EE,L9,1EE,45,18,27,24
L9  1EF,L9,1EF,43,21,22,26
L9  1EG,L9,1EG,37,18,19,19
L9  1EH,L9,1EH,61,35,26,31
L9  1EJ,L9,1EJ,60,28,32,32
L9  1EL,L9,1EL,79,33,46,35
L9  1EN,L9,1EN,85,35,50,36
L9  1EP,L9,1EP,103,73,30,73
L9  1EQ,L9,1EQ,63,23,40,34
L9  1ER,L9,1ER,65,32,33,36
L9  1ES,L9,1ES,63,30,33,36
L9  1EW,L9,1EW,76,31,45,51
L9  1EX,L9,1EX,16,12,4,9
L9  1EY,L9,1EY,101,58,43,47
L9  1EZ,L9,1EZ,67,49,18,40
L9  1FB,L9,1FB,120,60,60,42
L9  1HB,L9,1HB,21,18,3,15
L9  1HF,L9,1HF,147,68,79,64
L9  1HG,L9,1HG,111,53,58,53
L9  1HH,L9,1HH,85,40,45,38
L9  1HJ,L9,1HJ,37,23,14,18
L9  1HL,L9,1HL,46,22,24,21
L9  1HN,L9,1HN,81,38,43,41
L9  1HQ,L9,1HQ,95,41,54,44
L9  1HU,L9,1HU,36,17,19,34
L9  1HW,L9,1HW,20,12,8,15
L9  1HX,L9,1HX,107,55,52,48
L9  1HY,L9,1HY,67,35,32,32
L9  1HZ,L9,1HZ,16,10,6,10
L9  1JA,L9,1JA,57,29,28,29
L9  1JB,L9,1JB,133,70,63,58
L9  1JD,L9,1JD,43,20,23,19
L9  1JE,L9,1JE,38,20,18,16
L9  1JF,L9,1JF,46,24,22,17
L9  1JG,L9,1JG,36,19,17,20
L9  1JH,L9,1JH,57,30,27,26
L9  1JJ,L9,1JJ,32,16,16,15
L9  1JL,L9,1JL,108,54,54,46
L9  1JN,L9,1JN,172,80,92,80
L9  1JP,L9,1JP,9,4,5,4
L9  1JQ,L9,1JQ,68,33,35,29
L9  1JR,L9,1JR,82,43,39,42
L9  1JS,L9,1JS,89,43,46,41
L9  1JT,L9,1JT,27,13,14,16
L9  1JU,L9,1JU,24,10,14,14
L9  1JW,L9,1JW,124,70,54,56
L9  1JX,L9,1JX,6,3,3,4
L9  1JY,L9,1JY,93,50,43,41
L9  1JZ,L9,1JZ,50,23,27,27
L9  1LA,L9,1LA,31,16,15,12
L9  1LB,L9,1LB,96,40,56,42
L9  1LD,L9,1LD,143,57,86,56
L9  1LE,L9,1LE,33,10,23,15
L9  1LF,L9,1LF,23,14,9,9
L9  1LG,L9,1LG,52,21,31,24
L9  1LJ,L9,1LJ,31,15,16,12
L9  1LR,L9,1LR,86,58,28,71
L9  1LS,L9,1LS,38,25,13,30
L9  1NB,L9,1NB,25,10,15,10
L9  2AA,L9,2AA,95,46,49,32
L9  2AB,L9,2AB,77,39,38,26
L9  2AD,L9,2AD,45,23,22,18
L9  2AE,L9,2AE,75,36,39,29
L9  2AF,L9,2AF,43,21,22,16
L9  2AG,L9,2AG,59,31,28,20
L9  2AH,L9,2AH,111,52,59,38
L9  2AJ,L9,2AJ,53,28,25,19
L9  2AL,L9,2AL,54,29,25,24
L9  2AN,L9,2AN,35,18,17,12
L9  2AP,L9,2AP,90,51,39,34
L9  2AR,L9,2AR,88,47,41,35
L9  2AS,L9,2AS,28,14,14,13
L9  2AT,L9,2AT,87,38,49,33
L9  2AU,L9,2AU,63,30,33,27
L9  2AW,L9,2AW,88,50,38,33
L9  2AX,L9,2AX,106,54,52,41
L9  2AY,L9,2AY,94,47,47,32
L9  2AZ,L9,2AZ,69,33,36,22
L9  2BA,L9,2BA,58,24,34,20
L9  2BB,L9,2BB,36,17,19,12
L9  2BD,L9,2BD,33,15,18,11
L9  2BE,L9,2BE,52,32,20,35
L9  2BG,L9,2BG,105,56,49,43
L9  2BH,L9,2BH,102,49,53,45
L9  2BJ,L9,2BJ,111,56,55,48
L9  2BL,L9,2BL,58,41,17,27
L9  2BP,L9,2BP,71,45,26,37
L9  2BQ,L9,2BQ,86,44,42,35
L9  2BR,L9,2BR,74,37,37,36
L9  2BS,L9,2BS,47,24,23,19
L9  2BT,L9,2BT,28,16,12,9
L9  2BU,L9,2BU,5,2,3,4
L9  2BW,L9,2BW,33,15,18,13
L9  2BX,L9,2BX,9,8,1,5
L9  2BY,L9,2BY,86,43,43,32
L9  2DA,L9,2DA,98,44,54,39
L9  2DB,L9,2DB,46,25,21,19
L9  2DD,L9,2DD,65,31,34,25
L9  2DE,L9,2DE,101,49,52,38
L9  2DF,L9,2DF,43,18,25,17
L9  2DG,L9,2DG,2,2,0,2
L9  2DJ,L9,2DJ,38,16,22,12
L9  2DP,L9,2DP,120,67,53,78
L9  2DR,L9,2DR,23,7,16,9
L9  2DT,L9,2DT,83,33,50,27
L9  3AA,L9,3AA,45,24,21,15
L9  3AB,L9,3AB,29,14,15,13
L9  3AD,L9,3AD,23,6,17,10
L9  3AE,L9,3AE,43,22,21,14
L9  3AF,L9,3AF,100,42,58,35
L9  3AG,L9,3AG,101,52,49,38
L9  3AH,L9,3AH,27,12,15,10
L9  3AJ,L9,3AJ,22,10,12,10
L9  3AL,L9,3AL,104,54,50,42
L9  3AN,L9,3AN,192,97,95,67
L9  3AP,L9,3AP,37,19,18,15
L9  3AQ,L9,3AQ,59,25,34,22
L9  3AR,L9,3AR,85,42,43,34
L9  3AS,L9,3AS,30,15,15,9
L9  3AT,L9,3AT,84,41,43,36
L9  3AU,L9,3AU,74,37,37,31
L9  3AW,L9,3AW,177,95,82,57
L9  3AX,L9,3AX,64,33,31,26
L9  3AY,L9,3AY,79,37,42,32
L9  3AZ,L9,3AZ,39,21,18,20
L9  3BA,L9,3BA,61,34,27,24
L9  3BB,L9,3BB,35,13,22,14
L9  3BD,L9,3BD,34,19,15,10
L9  3BE,L9,3BE,39,20,19,14
L9  3BG,L9,3BG,64,31,33,33
L9  3BH,L9,3BH,73,34,39,35
L9  3BJ,L9,3BJ,82,44,38,34
L9  3BL,L9,3BL,21,14,7,8
L9  3BN,L9,3BN,53,23,30,24
L9  3BP,L9,3BP,122,69,53,48
L9  3BQ,L9,3BQ,82,41,41,31
L9  3BR,L9,3BR,81,37,44,32
L9  3BS,L9,3BS,36,18,18,12
L9  3BT,L9,3BT,51,25,26,18
L9  3BU,L9,3BU,1,1,0,1
L9  3BW,L9,3BW,61,29,32,28
L9  3BX,L9,3BX,50,21,29,15
L9  3BY,L9,3BY,5,4,1,4
L9  3BZ,L9,3BZ,2,2,0,2
L9  3DA,L9,3DA,99,50,49,34
L9  3DB,L9,3DB,20,12,8,8
L9  3DD,L9,3DD,95,51,44,47
L9  3DF,L9,3DF,796,796,0,0
L9  3DG,L9,3DG,60,32,28,24
L9  3DN,L9,3DN,34,13,21,28
L9  4GA,L9,4GA,26,13,13,11
L9  4RA,L9,4RA,40,25,15,16
L9  4RB,L9,4RB,69,25,44,36
L9  4RD,L9,4RD,27,13,14,12
L9  4RJ,L9,4RJ,52,26,26,20
L9  4RL,L9,4RL,50,24,26,28
L9  4RN,L9,4RN,9,4,5,7
L9  4RR,L9,4RR,55,31,24,31
L9  4RS,L9,4RS,51,24,27,26
L9  4RT,L9,4RT,44,22,22,26
L9  4RU,L9,4RU,56,33,23,30
L9  4RW,L9,4RW,22,10,12,14
L9  4RX,L9,4RX,8,4,4,4
L9  4RY,L9,4RY,56,25,31,22
L9  4RZ,L9,4RZ,88,40,48,33
L9  4SA,L9,4SA,32,11,21,13
L9  4SB,L9,4SB,60,33,27,23
L9  4SD,L9,4SD,26,12,14,10
L9  4SE,L9,4SE,81,40,41,29
L9  4SF,L9,4SF,82,33,49,28
L9  4SG,L9,4SG,65,36,29,31
L9  4SH,L9,4SH,71,34,37,24
L9  4SJ,L9,4SJ,70,31,39,29
L9  4SL,L9,4SL,51,22,29,20
L9  4SN,L9,4SN,39,20,19,17
L9  4SW,L9,4SW,63,28,35,29
L9  5AA,L9,5AA,4,3,1,3
L9  5AD,L9,5AD,34,16,18,14
L9  5AE,L9,5AE,33,11,22,27
L9  5AH,L9,5AH,4,1,3,1
L9  5AW,L9,5AW,10,5,5,6
L9  6AA,L9,6AA,67,32,35,36
L9  6AB,L9,6AB,70,31,39,36
L9  6AD,L9,6AD,76,45,31,39
L9  6AE,L9,6AE,18,5,13,7
L9  6AG,L9,6AG,62,27,35,27
L9  6AH,L9,6AH,83,37,46,36
L9  6AJ,L9,6AJ,53,25,28,25
L9  6AL,L9,6AL,33,12,21,17
L9  6AN,L9,6AN,54,27,27,18
L9  6AP,L9,6AP,15,9,6,4
L9  6AQ,L9,6AQ,87,46,41,37
L9  6AR,L9,6AR,82,37,45,29
L9  6AS,L9,6AS,50,26,24,24
L9  6AT,L9,6AT,34,15,19,21
L9  6AU,L9,6AU,63,31,32,22
L9  6AX,L9,6AX,47,16,31,22
L9  6AY,L9,6AY,133,67,66,44
L9  6AZ,L9,6AZ,84,36,48,35
L9  6BA,L9,6BA,73,34,39,27
L9  6BB,L9,6BB,31,13,18,15
L9  6BD,L9,6BD,71,33,38,32
L9  6BE,L9,6BE,66,33,33,33
L9  6BG,L9,6BG,81,35,46,34
L9  6BJ,L9,6BJ,67,38,29,24
L9  6BL,L9,6BL,70,31,39,31
L9  6BN,L9,6BN,60,33,27,34
L9  6BP,L9,6BP,44,18,26,22
L9  6BQ,L9,6BQ,67,30,37,32
L9  6BR,L9,6BR,39,22,17,18
L9  6BT,L9,6BT,61,38,23,48
L9  6BU,L9,6BU,70,38,32,31
L9  6BW,L9,6BW,47,26,21,21
L9  6BX,L9,6BX,15,8,7,7
L9  6BY,L9,6BY,81,36,45,46
L9  6BZ,L9,6BZ,61,30,31,32
L9  6DA,L9,6DA,20,7,13,12
L9  6DB,L9,6DB,23,11,12,11
L9  6DG,L9,6DG,63,29,34,36
L9  6DH,L9,6DH,85,41,44,66
L9  6DL,L9,6DL,40,24,16,19
L9  6DN,L9,6DN,6,2,4,6
L9  6DP,L9,6DP,93,51,42,47
L9  6DR,L9,6DR,51,26,25,28
L9  6DT,L9,6DT,40,19,21,38
L9  6DZ,L9,6DZ,76,38,38,29
L9  6EB,L9,6EB,114,52,62,46
L9  6ED,L9,6ED,120,58,62,50
L9  6EE,L9,6EE,29,12,17,13
L9  6EF,L9,6EF,23,8,15,9
L9  6EG,L9,6EG,99,46,53,38
L9  6EL,L9,6EL,8,6,2,6
L9  6EN,L9,6EN,10,4,6,5
L9  6EP,L9,6EP,83,39,44,48
L9  6GA,L9,6GA,77,37,40,22
L9  6GB,L9,6GB,65,33,32,31
L9  6GD,L9,6GD,75,41,34,29
L9  6GE,L9,6GE,10,6,4,3
L9  6GF,L9,6GF,54,36,18,40
L9  7AA,L9,7AA,3,2,1,1
L9  7AB,L9,7AB,9,5,4,3
L9  7AD,L9,7AD,34,17,17,12
L9  7AE,L9,7AE,70,35,35,33
L9  7AH,L9,7AH,88,37,51,46
L9  7AL,L9,7AL,104,59,45,45
L9  7AR,L9,7AR,7,6,1,2
L9  7HA,L9,7HA,20,10,10,11
L9  7JU,L9,7JU,58,9,49,0
L9  7LF,L9,7LF,207,97,110,66
L9  7LG,L9,7LG,198,104,94,64
L9  7LH,L9,7LH,695,693,2,0
L9  7LT,L9,7LT,23,12,11,8
L9  7LU,L9,7LU,179,94,85,56
L9  7LX,L9,7LX,39,22,17,14
L9  7LZ,L9,7LZ,45,25,20,14
L9  8AA,L9,8AA,38,19,19,17
L9  8AB,L9,8AB,32,16,16,15
L9  8AD,L9,8AD,44,25,19,25
L9  8AE,L9,8AE,32,20,12,20
L9  8AG,L9,8AG,22,17,5,19
L9  8AJ,L9,8AJ,44,25,19,24
L9  8AL,L9,8AL,43,25,18,25
L9  8AN,L9,8AN,14,7,7,11
L9  8AP,L9,8AP,19,13,6,18
L9  8AQ,L9,8AQ,11,8,3,7
L9  8AS,L9,8AS,57,23,34,20
L9  8AT,L9,8AT,82,44,38,33
L9  8AU,L9,8AU,100,42,58,40
L9  8AW,L9,8AW,25,20,5,23
L9  8AX,L9,8AX,65,33,32,24
L9  8AY,L9,8AY,62,34,28,26
L9  8AZ,L9,8AZ,72,32,40,34
L9  8BA,L9,8BA,2,2,0,2
L9  8BB,L9,8BB,65,34,31,24
L9  8BD,L9,8BD,28,14,14,14
L9  8BE,L9,8BE,80,38,42,43
L9  8BG,L9,8BG,46,27,19,17
L9  8BH,L9,8BH,84,45,39,33
L9  8BJ,L9,8BJ,26,12,14,10
L9  8BL,L9,8BL,16,9,7,10
L9  8BN,L9,8BN,42,26,16,31
L9  8BP,L9,8BP,26,16,10,12
L9  8BQ,L9,8BQ,66,36,30,29
L9  8BR,L9,8BR,25,11,14,9
L9  8BS,L9,8BS,59,30,29,29
L9  8BT,L9,8BT,61,28,33,28
L9  8BU,L9,8BU,12,6,6,7
L9  8BX,L9,8BX,95,47,48,30
L9  8BY,L9,8BY,40,25,15,20
L9  8BZ,L9,8BZ,46,28,18,25
L9  8DA,L9,8DA,128,67,61,47
L9  8DB,L9,8DB,92,46,46,36
L9  8DD,L9,8DD,63,29,34,28
L9  8DE,L9,8DE,57,25,32,24
L9  8DF,L9,8DF,65,33,32,21
L9  8DG,L9,8DG,64,29,35,26
L9  8DH,L9,8DH,69,31,38,29
L9  8DJ,L9,8DJ,69,31,38,31
L9  8DL,L9,8DL,45,21,24,21
L9  8DN,L9,8DN,81,44,37,38
L9  8DP,L9,8DP,125,63,62,52
L9  8DQ,L9,8DQ,79,35,44,34
L9  8DR,L9,8DR,86,39,47,34
L9  8DS,L9,8DS,50,23,27,21
L9  8DT,L9,8DT,55,31,24,25
L9  8DU,L9,8DU,84,41,43,33
L9  8DW,L9,8DW,62,28,34,26
L9  8DX,L9,8DX,117,56,61,42
L9  8DY,L9,8DY,94,44,50,41
L9  8DZ,L9,8DZ,107,50,57,45
L9  8EA,L9,8EA,40,16,24,19
L9  8EB,L9,8EB,77,29,48,32
L9  8ED,L9,8ED,88,42,46,40
L9  8EE,L9,8EE,27,14,13,12
L9  8EF,L9,8EF,61,35,26,22
L9  8EG,L9,8EG,96,43,53,44
L9  8EH,L9,8EH,12,9,3,10
L9  8EP,L9,8EP,160,77,83,53
L9  8EQ,L9,8EQ,12,8,4,12
L9  8ER,L9,8ER,51,21,30,23
L9  8ES,L9,8ES,21,8,13,10
L9  8ET,L9,8ET,12,6,6,5
L9  8EU,L9,8EU,23,11,12,11
L9  8EW,L9,8EW,18,11,7,14
L9  8EX,L9,8EX,83,38,45,34
L9  8EY,L9,8EY,15,8,7,7
L9  8EZ,L9,8EZ,17,9,8,10
L9  8HA,L9,8HA,143,73,70,50
L9  8HF,L9,8HF,102,51,51,33
L9  8HG,L9,8HG,66,36,30,24
L9  8HH,L9,8HH,45,26,19,14
L9  8HJ,L9,8HJ,57,29,28,18
L9  8HP,L9,8HP,18,7,11,7
L9  8HQ,L9,8HQ,31,18,13,9
L9  8HR,L9,8HR,49,20,29,18
L9  8HS,L9,8HS,49,22,27,17
L9  8HW,L9,8HW,48,23,25,17
L9  9AD,L9,9AD,70,32,38,27
L9  9AE,L9,9AE,82,42,40,36
L9  9AH,L9,9AH,78,39,39,28
L9  9AJ,L9,9AJ,34,18,16,14
L9  9AL,L9,9AL,57,28,29,27
L9  9AN,L9,9AN,48,23,25,22
L9  9AP,L9,9AP,25,10,15,12
L9  9AQ,L9,9AQ,76,38,38,30
L9  9AR,L9,9AR,53,34,19,21
L9  9AS,L9,9AS,61,26,35,21
L9  9AT,L9,9AT,26,10,16,15
L9  9AU,L9,9AU,22,10,12,14
L9  9AW,L9,9AW,77,34,43,33
L9  9AX,L9,9AX,11,9,2,7
L9  9AY,L9,9AY,70,32,38,38
L9  9AZ,L9,9AZ,34,15,19,12
L9  9BA,L9,9BA,123,51,72,50
L9  9BB,L9,9BB,82,40,42,35
L9  9BD,L9,9BD,14,7,7,13
L9  9BE,L9,9BE,28,11,17,12
L9  9BG,L9,9BG,73,35,38,30
L9  9BH,L9,9BH,87,44,43,34
L9  9BJ,L9,9BJ,122,58,64,45
L9  9BL,L9,9BL,26,12,14,12
L9  9BN,L9,9BN,79,42,37,33
L9  9BP,L9,9BP,75,39,36,35
L9  9BQ,L9,9BQ,61,28,33,29
L9  9BR,L9,9BR,83,47,36,35
L9  9BS,L9,9BS,85,39,46,36
L9  9BT,L9,9BT,45,19,26,26
L9  9BU,L9,9BU,95,39,56,43
L9  9BW,L9,9BW,59,31,28,28
L9  9BX,L9,9BX,82,38,44,36
L9  9BY,L9,9BY,32,16,16,16
L9  9BZ,L9,9BZ,31,19,12,16
L9  9DA,L9,9DA,35,15,20,17
L9  9DB,L9,9DB,19,11,8,15
L9  9DD,L9,9DD,58,28,30,25
L9  9DE,L9,9DE,64,31,33,29
L9  9DF,L9,9DF,55,26,29,25
L9  9DG,L9,9DG,83,38,45,42
L9  9DH,L9,9DH,25,13,12,12
L9  9DJ,L9,9DJ,132,69,63,40
L9  9DL,L9,9DL,30,16,14,13
L9  9DN,L9,9DN,55,27,28,24
L9  9DP,L9,9DP,115,62,53,44
L9  9DQ,L9,9DQ,55,29,26,26
L9  9DR,L9,9DR,120,50,70,43
L9  9DS,L9,9DS,87,39,48,45
L9  9DT,L9,9DT,52,24,28,24
L9  9DU,L9,9DU,45,25,20,25
L9  9DW,L9,9DW,71,33,38,30
L9  9DX,L9,9DX,27,7,20,14
L9  9DY,L9,9DY,35,18,17,14
L9  9DZ,L9,9DZ,28,13,15,11
L9  9EA,L9,9EA,21,9,12,10
L9  9EB,L9,9EB,23,9,14,10
L9  9ED,L9,9ED,24,12,12,11
L9  9EE,L9,9EE,52,25,27,23
L9  9EF,L9,9EF,71,31,40,26
L9  9EG,L9,9EG,42,21,21,18
L9  9EH,L9,9EH,43,20,23,17
L9  9EN,L9,9EN,1,1,0,1
L9  9EP,L9,9EP,20,11,9,8
L9  9EQ,L9,9EQ,66,30,36,23
L9  9ES,L9,9ES,53,24,29,21
L9  9ET,L9,9ET,18,7,11,8
L9  9EW,L9,9EW,29,13,16,12
L9  9EX,L9,9EX,67,27,40,24
L9  9HA,L9,9HA,27,16,11,15
L9  9HG,L9,9HG,17,7,10,6
L9  9HH,L9,9HH,60,25,35,46
L9  9HL,L9,9HL,182,86,96,62
L9  9HN,L9,9HN,101,56,45,33
L9  9HQ,L9,9HQ,51,27,24,48
L9  9HT,L9,9HT,107,55,52,37
L9  9HU,L9,9HU,16,6,10,6
L9  9HX,L9,9HX,14,7,7,4
L9  9HY,L9,9HY,150,73,77,57
L9  9HZ,L9,9HZ,195,101,94,63
L9  9JA,L9,9JA,113,52,61,34
L9  9JB,L9,9JB,52,24,28,17
L9  9JD,L9,9JD,25,11,14,9
L9  9JE,L9,9JE,22,13,9,7
L9  9JF,L9,9JF,25,11,14,9
